,Rk,Player,Nation,Pos,Squad,Age,Born,90s,Tkl,TklW,Def 3rd,Mid 3rd,Att 3rd,Tkl,Att,Tkl%,Past,Blocks,Sh,Pass,Int,Tkl+Int,Clr,Err,Matches
0,1,Rodrigo Abascal,uy URU,DF,Boavista,27,1994,26.5,74,45,44,28,2,46,75,61.3,29,36,14,22,43,117,103,0,Matches
1,2,Giorgi Aburjania,ge GEO,MF,Gil Vicente FC,26,1995,8.6,22,13,8,13,1,6,25,24.0,19,9,3,6,8,30,8,0,Matches
2,3,Antonio Adán,es ESP,GK,Sporting CP,34,1987,33.0,1,0,1,0,0,1,1,100.0,0,0,0,0,2,3,11,0,Matches
3,4,João Afonso Crispim,br BRA,MF,Gil Vicente FC,26,1995,0.2,1,1,0,1,0,0,3,0.0,3,0,0,0,0,1,0,0,Matches
4,5,João Afonso,pt POR,DF,Santa Clara,31,1990,12.4,14,8,9,5,0,10,18,55.6,8,13,11,2,17,31,57,0,Matches
5,6,Lucas Áfrico,br BRA,DF,Estoril,26,1995,10.7,4,2,2,2,0,2,5,40.0,3,13,10,3,12,16,40,1,Matches
6,7,Salvador Agra,pt POR,"FW,MF",Tondela,29,1991,29.0,26,14,13,11,2,10,28,35.7,18,9,2,7,11,37,12,0,Matches
7,8,Mohamed Aidara,ci CIV,DF,FC Vizela,24,1996,15.0,13,8,11,2,0,7,16,43.8,9,21,11,10,23,36,83,0,Matches
8,9,Chima Akas,ng NGA,DF,B-SAD,27,1994,19.5,29,20,13,15,1,15,28,53.6,13,25,12,13,26,55,53,0,Matches
9,10,Alex,br BRA,DF,Famalicão,22,1999,16.4,32,22,22,9,1,16,27,59.3,11,25,20,5,17,49,65,1,Matches
10,11,Almoatasembellah Ali,ly LBY,MF,Braga,25,1996,28.5,63,34,22,33,8,23,50,46.0,27,26,9,17,43,106,28,1,Matches
11,12,Ali Alipour,ir IRN,FW,Marítimo,25,1995,20.0,14,10,3,9,2,1,9,11.1,8,16,2,14,2,16,14,0,Matches
12,13,Allano,br BRA,"FW,MF",Santa Clara,26,1995,12.1,25,16,13,8,4,7,19,36.8,12,26,5,21,10,35,9,0,Matches
13,14,André Almeida,pt POR,DF,Benfica,30,1990,8.9,18,9,6,8,4,10,18,55.6,8,12,3,9,3,21,11,0,Matches
14,15,Domingos André Ribeiro Almeida,pt POR,"MF,FW",Vitória,21,2000,20.2,42,21,15,20,7,14,38,36.8,24,19,4,15,17,59,11,0,Matches
15,16,Baptiste Aloé,fr FRA,DF,Arouca,27,1994,0.7,1,0,0,1,0,1,1,100.0,0,0,0,0,3,4,4,0,Matches
16,17,Omri Altman,il ISR,MF,Arouca,27,1994,1.5,4,1,0,3,1,2,2,100.0,0,2,1,1,2,6,1,0,Matches
17,18,Alejandro Alvarado Jr.,us USA,"MF,FW",FC Vizela,18,2003,0.7,4,4,0,4,0,3,3,100.0,0,0,0,0,0,4,1,0,Matches
18,19,Luís Alves,pt POR,DF,Paços,19,2001,3.4,11,6,8,3,0,8,15,53.3,7,1,1,0,6,17,6,0,Matches
19,20,Marcelo Alves,br BRA,DF,Tondela,23,1998,8.1,6,5,5,1,0,3,5,60.0,2,13,11,2,6,12,32,0,Matches
20,21,Ricardo Miguel Martins Alves,pt POR,"DF,MF",Tondela,30,1991,9.2,17,7,9,7,1,10,13,76.9,3,10,4,6,10,27,30,1,Matches
21,22,Pedro Amador,pt POR,"MF,DF",Moreirense,22,1998,13.3,25,13,19,5,1,13,22,59.1,9,14,3,11,22,47,25,0,Matches
22,23,Amarildo,br BRA,DF,Famalicão,22,1999,0.0,0,0,0,0,0,0,0,,0,0,0,0,0,0,0,0,Matches
23,24,André Amaro,co COL,DF,Vitória,18,2002,6.3,8,6,8,0,0,6,10,60.0,4,6,3,3,6,14,19,0,Matches
24,25,Artur Jorge Marques Amorim,pt POR,DF,Moreirense,26,1994,22.2,26,18,14,11,1,15,24,62.5,9,23,12,11,34,60,87,1,Matches
25,26,Anderson,br BRA,"FW,MF",Portimonense,23,1998,11.4,18,11,6,8,4,7,19,36.8,12,13,0,13,5,23,3,0,Matches
26,27,Rodrigo Andrad,pt POR,MF,Marítimo,19,2001,0.1,0,0,0,0,0,0,0,,0,0,0,0,1,1,0,0,Matches
27,28,Léo Andrade,br BRA,DF,Marítimo,23,1998,14.3,28,20,21,7,0,14,20,70.0,6,30,21,9,20,48,78,0,Matches
28,29,André André,pt POR,MF,Vitória,31,1989,10.4,23,15,5,11,7,10,19,52.6,9,9,5,4,8,31,3,0,Matches
29,30,Mauro Andrés Caballero,py PAR,FW,Arouca,26,1994,0.0,0,0,0,0,0,0,0,,0,0,0,0,0,0,0,0,Matches
30,31,Andrew,br BRA,GK,Gil Vicente FC,20,2001,10.0,0,0,0,0,0,0,0,,0,0,0,0,0,0,4,1,Matches
31,32,Iván Angulo,co COL,"FW,MF",Portimonense,22,1999,26.2,38,23,17,13,8,17,36,47.2,19,23,1,22,24,62,27,0,Matches
32,33,Antony,br BRA,"FW,MF",Arouca,19,2001,7.4,21,12,11,6,4,9,20,45.0,11,9,0,9,7,28,3,0,Matches
33,34,Vitorino Antunes,pt POR,DF,Paços,34,1987,28.2,51,29,29,19,3,31,54,57.4,23,19,6,13,31,82,67,0,Matches
34,35,Bilel Aouacheria,fr FRA,"FW,MF",Gil Vicente FC,27,1994,7.1,7,3,1,4,2,2,3,66.7,1,5,0,5,4,11,5,0,Matches
35,36,Wilinton Aponzá,co COL,"FW,MF",Portimonense,21,2000,8.3,5,1,1,3,1,3,5,60.0,2,6,0,6,1,6,7,0,Matches
36,37,Brian Araújo,fr FRA,GK,Gil Vicente FC,21,2000,1.0,0,0,0,0,0,0,0,,0,0,0,0,0,0,0,0,Matches
37,38,Henrique Araújo,pt POR,FW,Benfica,19,2002,1.4,0,0,0,0,0,0,0,,0,0,0,0,0,0,0,0,Matches
38,39,Guilherme Araújo Soares,pt POR,DF,Braga,20,2001,0.5,0,0,0,0,0,0,1,0.0,1,1,1,0,1,1,1,0,Matches
39,40,Tiago Araújo,pt POR,"DF,FW",Arouca,20,2001,5.3,12,8,9,3,0,7,15,46.7,8,8,2,6,2,14,13,0,Matches
40,41,Tomás Araújo,pt POR,DF,Benfica,19,2002,1.1,0,0,0,0,0,0,1,0.0,1,3,0,3,0,0,5,0,Matches
41,42,Telmo Arcanjo,cv CPV,"MF,FW",Tondela,20,2001,1.4,3,3,1,2,0,0,0,,0,2,0,2,0,3,0,0,Matches
42,43,Arthur,br BRA,"FW,MF",Estoril,23,1998,24.4,32,19,9,14,9,8,25,32.0,17,20,1,19,15,47,17,0,Matches
43,44,Gustavo Assuncao,pt POR,MF,Famalicão,21,2000,6.7,21,13,10,10,1,12,24,50.0,12,6,1,5,5,26,13,0,Matches
44,45,Fernando Augusto,br BRA,GK,Arouca,24,1997,6.9,0,0,0,0,0,0,0,,0,0,0,0,0,0,4,0,Matches
45,46,Javier Avilés,es ESP,"MF,FW",Tondela,23,1997,1.7,3,2,1,1,1,3,5,60.0,2,3,0,3,1,4,0,0,Matches
46,47,Chidozie Awaziem,ng NGA,DF,Boavista,24,1997,3.0,4,2,2,2,0,2,2,100.0,0,3,3,0,2,6,19,0,Matches
47,48,Abdoulaye Ba,sn SEN,DF,Arouca,30,1991,14.9,21,11,17,4,0,10,17,58.8,7,13,7,6,29,50,64,0,Matches
48,49,Abdoulaye Ba,sn SEN,DF,Moreirense,30,1991,1.0,4,2,3,1,0,3,3,100.0,0,1,0,1,1,5,3,0,Matches
49,50,Marco Baixinho,pt POR,DF,Paços,32,1989,24.3,20,12,16,3,1,9,22,40.9,13,34,21,13,45,65,68,1,Matches
50,51,Ibrahima Bamba,ci CIV,MF,Vitória,19,2002,3.3,8,4,2,5,1,5,6,83.3,1,4,0,4,9,17,6,0,Matches
51,52,Daniel Bandeira,pt POR,MF,Vitória,21,2000,0.2,0,0,0,0,0,0,1,0.0,1,0,0,0,0,0,1,0,Matches
52,53,Simon Banza,fr FRA,FW,Famalicão,24,1996,25.9,16,10,4,7,5,5,14,35.7,9,14,2,12,9,25,32,0,Matches
53,54,Yves Baraye,sn SEN,"FW,MF",B-SAD,29,1992,11.8,16,5,8,4,4,9,16,56.3,7,20,2,18,13,29,10,0,Matches
54,55,Rafael Barbosa,pt POR,"MF,FW",Tondela,25,1996,19.2,18,8,4,9,5,7,23,30.4,16,12,1,11,9,27,4,0,Matches
55,56,Romário Baró,pt POR,MF,Estoril,21,2000,4.3,7,2,2,3,2,3,8,37.5,5,2,1,1,2,9,3,0,Matches
56,57,Oscar Barreto,co COL,"FW,MF",Santa Clara,28,1993,3.9,13,8,6,4,3,6,12,50.0,6,8,0,8,4,17,3,0,Matches
57,58,Gil Bastião Dias,pt POR,"DF,FW",Benfica,24,1996,7.3,19,11,9,6,4,8,16,50.0,8,9,0,9,12,31,5,0,Matches
58,59,Dylan Batubinsika,fr FRA,DF,Famalicão,25,1996,16.7,22,14,15,7,0,10,15,66.7,5,20,17,3,41,63,76,1,Matches
59,60,Clésio Baúque,mz MOZ,"DF,FW",Marítimo,26,1994,5.3,9,7,7,1,1,4,8,50.0,4,4,0,4,8,17,9,0,Matches
60,61,Bebeto,br BRA,"DF,MF",Tondela,31,1990,15.4,69,49,41,24,4,44,73,60.3,29,27,2,25,31,100,29,0,Matches
61,62,Alireza Beiranvand,ir IRN,GK,Boavista,28,1992,7.5,0,0,0,0,0,0,1,0.0,1,0,0,0,1,1,9,1,Matches
62,63,Stefano Beltrame,it ITA,MF,Marítimo,28,1993,15.4,11,4,4,5,2,3,13,23.1,10,15,2,13,18,29,7,0,Matches
63,64,Berna,pt POR,MF,Braga,18,2002,0.0,0,0,0,0,0,0,0,,0,0,0,0,0,0,0,0,Matches
64,65,Paulo Bernardo,pt POR,MF,Benfica,19,2002,8.7,26,13,6,16,4,13,28,46.4,15,15,4,11,8,34,5,0,Matches
65,66,Beto,gw GNB,FW,Portimonense,23,1998,3.0,0,0,0,0,0,0,2,0.0,2,4,0,4,0,0,4,0,Matches
66,67,Aylton Boa Morte,pt POR,"FW,MF",Portimonense,27,1993,12.3,10,6,3,2,5,7,19,36.8,12,7,0,7,6,16,8,0,Matches
67,68,Kennedy Boateng,tg TOG,DF,Santa Clara,24,1996,23.3,43,35,34,9,0,25,31,80.6,6,14,9,5,35,78,107,2,Matches
68,69,Kiko Bondoso,pt POR,FW,FC Vizela,25,1995,30.2,33,18,8,16,9,18,51,35.3,33,18,4,14,16,49,18,0,Matches
69,70,Trova Boni,bf BFA,MF,B-SAD,21,1999,4.9,13,6,7,6,0,7,13,53.8,6,4,2,2,9,22,6,0,Matches
70,71,Toni Borevkovic,hr CRO,DF,Vitória,24,1997,22.1,21,11,18,3,0,13,25,52.0,12,15,9,6,35,56,69,3,Matches
71,72,Gonçalo Borges,pt POR,MF,Porto,20,2001,0.1,1,0,0,0,1,0,0,,0,0,0,0,0,1,0,0,Matches
72,73,Neto Borges,br BRA,"DF,MF",Tondela,24,1996,23.7,53,35,34,17,2,24,41,58.5,17,23,5,18,49,102,67,0,Matches
73,74,Pedro Borges,br BRA,MF,Tondela,24,1997,22.1,66,40,29,34,3,24,63,38.1,39,33,6,27,28,94,31,0,Matches
74,75,Mohamed Bouldini,ma MAR,FW,Santa Clara,25,1995,1.7,2,1,0,1,1,1,1,100.0,0,2,2,0,0,2,2,0,Matches
75,76,Rafael Bracalli,br BRA,GK,Boavista,40,1981,26.5,2,1,2,0,0,1,2,50.0,1,0,0,0,3,5,19,1,Matches
76,77,Victor Braga,br BRA,GK,Arouca,29,1992,23.1,0,0,0,0,0,0,2,0.0,2,0,0,0,0,0,19,2,Matches
77,78,Daniel Bragança,pt POR,MF,Sporting CP,22,1999,8.7,25,15,10,12,3,15,27,55.6,12,10,0,10,17,42,1,0,Matches
78,79,Pedro Brazão,pt POR,"MF,FW",Famalicão,18,2002,4.2,5,5,4,1,0,4,10,40.0,6,8,1,7,2,7,1,0,Matches
79,80,Brunão,br BRA,MF,Arouca,24,1997,0.2,0,0,0,0,0,0,0,,0,0,0,0,1,1,1,0,Matches
80,81,Bruninho,br BRA,FW,Arouca,22,1999,3.3,4,2,0,2,2,1,2,50.0,1,6,0,6,1,5,1,0,Matches
81,82,David Bruno,pt POR,DF,Estoril,29,1992,13.5,11,8,9,1,1,6,13,46.2,7,13,9,4,16,27,28,0,Matches
82,83,Matheus Bueno,br BRA,"MF,FW",Gil Vicente FC,23,1998,7.3,9,7,4,3,2,2,4,50.0,2,7,1,6,3,12,3,0,Matches
83,84,André Bukia,cd COD,"FW,MF",Arouca,26,1995,28.5,24,12,9,8,7,18,34,52.9,16,22,0,22,15,39,9,0,Matches
84,85,Leonardo Buta,pt POR,DF,Braga,19,2002,1.5,1,0,0,1,0,1,1,100.0,0,2,1,1,4,5,3,0,Matches
85,86,Adrián Butzke,es ESP,FW,Paços,22,1999,6.4,1,1,0,1,0,1,2,50.0,1,0,0,0,1,2,7,0,Matches
86,87,Jovane Cabral,cv CPV,"MF,FW",Sporting CP,23,1998,3.8,5,2,0,3,2,1,6,16.7,5,4,0,4,1,6,1,0,Matches
87,88,Paulo Henrique Rodrigues Cabral,pt POR,DF,Santa Clara,24,1996,13.9,14,5,12,2,0,7,11,63.6,4,12,6,6,11,25,28,0,Matches
88,89,Jhonder Cádiz,ve VEN,"FW,DF",Famalicão,26,1995,5.0,4,3,1,2,1,1,4,25.0,3,3,0,3,2,6,2,0,Matches
89,90,João Caiado,pt POR,FW,Gil Vicente FC,22,1999,0.0,0,0,0,0,0,0,0,,0,0,0,0,0,0,0,0,Matches
90,91,Juan Calero,co COL,FW,Gil Vicente FC,22,1998,1.6,0,0,0,0,0,0,3,0.0,3,1,0,1,1,1,2,0,Matches
91,92,Diogo Calila,pt POR,"DF,MF",B-SAD,22,1998,21.3,28,16,21,7,0,20,28,71.4,8,26,11,15,17,45,58,0,Matches
92,93,Rafael Camacho,pt POR,"FW,MF",B-SAD,21,2000,9.8,7,7,2,3,2,4,6,66.7,2,4,0,4,2,9,7,0,Matches
93,94,Abel Camará,gw GNB,FW,B-SAD,31,1990,17.3,18,12,7,8,3,7,20,35.0,13,15,5,10,8,26,10,0,Matches
94,95,Ibrahima Camará,gn GUI,MF,Moreirense,22,1999,18.9,30,16,8,18,4,10,32,31.3,22,9,3,6,12,42,12,0,Matches
95,96,Gastón Campi,ar ARG,DF,Arouca,30,1991,4.0,3,3,1,2,0,0,4,0.0,4,4,3,1,8,11,8,0,Matches
96,97,Fali Candé,gw GNB,DF,Portimonense,23,1998,14.6,31,20,23,8,0,18,28,64.3,10,9,6,3,5,36,45,0,Matches
97,98,Francis Cann,gh GHA,"FW,MF",FC Vizela,23,1998,2.4,7,3,3,2,2,0,7,0.0,7,2,1,1,3,10,1,0,Matches
98,99,Reggie Cannon,us USA,DF,Boavista,23,1998,19.0,43,30,34,7,2,25,32,78.1,7,17,9,8,37,80,37,0,Matches
99,100,Fábio Cardoso,pt POR,DF,Porto,27,1994,12.0,8,4,4,4,0,7,10,70.0,3,11,9,2,10,18,34,0,Matches
100,101,Carlinhos,br BRA,MF,Portimonense,27,1994,25.4,41,24,23,15,3,16,42,38.1,26,27,8,19,16,57,15,1,Matches
101,102,Carlos,br BRA,FW,Santa Clara,25,1995,2.0,5,2,2,3,0,2,3,66.7,1,1,0,1,0,5,2,0,Matches
102,103,José Carlos,pt POR,DF,Gil Vicente FC,23,1998,27.3,57,35,30,19,8,27,50,54.0,23,27,11,16,41,98,73,0,Matches
103,104,Luíz Carlos,br BRA,MF,Paços,36,1985,28.9,66,49,21,38,7,29,76,38.2,47,32,14,18,28,94,33,0,Matches
104,105,João Carlos Teixeira,pt POR,"FW,MF",Famalicão,28,1993,8.8,9,3,0,5,4,4,11,36.4,7,9,1,8,4,13,6,0,Matches
105,106,David Carmo,pt POR,DF,Braga,22,1999,11.0,7,4,5,2,0,3,9,33.3,6,11,8,3,13,20,38,0,Matches
106,107,Carraça,pt POR,"DF,MF",B-SAD,28,1993,24.5,34,28,17,11,6,22,45,48.9,23,19,7,12,27,61,53,0,Matches
107,108,Anderson Carvalho,br BRA,MF,Santa Clara,31,1990,21.1,63,40,21,36,6,25,62,40.3,37,15,3,12,42,105,24,0,Matches
108,109,Duarte Carvalho,pt POR,MF,Estoril,19,2002,0.2,1,1,0,1,0,0,0,,0,0,0,0,0,1,0,0,Matches
109,110,Martim Carvalho,pt POR,MF,Benfica,18,2003,0.2,0,0,0,0,0,0,0,,0,0,0,0,0,0,0,0,Matches
110,111,Vitor Carvalho,br BRA,MF,Gil Vicente FC,24,1997,24.8,53,28,18,29,6,22,54,40.7,32,28,8,20,33,86,50,1,Matches
111,112,Cassiano,br BRA,FW,FC Vizela,32,1989,17.7,22,10,3,13,6,6,16,37.5,10,17,3,14,5,27,9,0,Matches
112,113,Mateo Cassierra,co COL,FW,B-SAD,24,1997,1.9,2,2,0,2,0,1,1,100.0,0,0,0,0,0,2,0,0,Matches
113,114,Moises Castillo,co COL,"DF,FW",Marítimo,20,2001,0.2,0,0,0,0,0,0,0,,0,1,1,0,0,0,0,0,Matches
114,115,André Castro,pt POR,MF,Braga,33,1988,12.8,25,11,4,13,8,8,27,29.6,19,20,5,15,10,35,11,0,Matches
115,116,Tomás Castro,pt POR,MF,B-SAD,22,1999,0.6,4,3,2,1,1,2,5,40.0,3,0,0,0,0,4,0,0,Matches
116,117,Geny Catamo,mz MOZ,DF,Sporting CP,20,2001,0.3,1,0,0,1,0,0,0,,0,0,0,0,1,2,0,0,Matches
117,118,Geny Catamo,mz MOZ,"FW,MF",Vitória,20,2001,2.5,1,1,0,1,0,1,2,50.0,1,2,0,2,0,1,1,1,Matches
118,119,Charles,br BRA,GK,FC Vizela,27,1994,14.0,1,0,1,0,0,1,4,25.0,3,0,0,0,1,2,9,2,Matches
119,120,Francisco Chico,pt POR,"MF,FW",B-SAD,23,1998,6.1,9,4,4,3,2,5,10,50.0,5,7,2,5,5,14,3,0,Matches
120,121,Fábio China,pt POR,DF,Marítimo,29,1992,6.4,12,6,5,6,1,5,8,62.5,3,6,1,5,9,21,22,1,Matches
121,122,Chiquinho,pt POR,FW,Estoril,21,2000,9.3,24,16,11,8,5,9,21,42.9,12,6,1,5,5,29,4,0,Matches
122,123,Chiquinho,pt POR,"MF,FW",Braga,26,1995,2.3,0,0,0,0,0,0,3,0.0,3,1,1,0,1,1,2,0,Matches
123,124,André Clóvis,br BRA,FW,Estoril,23,1997,9.7,5,2,1,3,1,2,6,33.3,4,9,2,7,6,11,4,0,Matches
124,125,Sebastián Coates,uy URU,DF,Sporting CP,30,1990,29.3,42,28,25,17,0,27,39,69.2,12,28,19,9,42,84,65,4,Matches
125,126,Racine Coly,sn SEN,DF,Estoril,25,1995,1.9,1,1,1,0,0,0,3,0.0,3,2,0,2,0,1,3,0,Matches
126,127,Francisco Conceição,pt POR,"MF,FW",Porto,18,2002,5.5,9,7,1,4,4,5,11,45.5,6,4,0,4,1,10,1,0,Matches
127,128,Rodrigo Conceição,pt POR,"DF,MF",Moreirense,21,2000,4.3,11,9,8,3,0,7,14,50.0,7,1,1,0,3,14,12,0,Matches
128,129,Abdu Conté,pt POR,"DF,MF",Moreirense,23,1998,15.3,23,10,19,4,0,12,16,75.0,4,8,2,6,7,30,18,0,Matches
129,130,Jeriel Córdova,ve VEN,"FW,MF",Boavista,19,2002,2.3,4,4,2,1,1,1,2,50.0,1,2,0,2,0,4,1,0,Matches
130,131,Jesús Corona,mx MEX,"DF,MF",Porto,28,1993,4.3,3,1,0,3,0,1,2,50.0,1,2,0,2,7,10,3,0,Matches
131,132,Alexandre Manuel Penetra Correia,pt POR,DF,Famalicão,19,2001,28.9,42,29,25,15,2,28,43,65.1,15,15,9,6,68,110,105,0,Matches
132,133,Rui Filipe Cunha Correia,pt POR,MF,Santa Clara,26,1995,13.4,17,8,11,5,1,9,27,33.3,18,7,2,5,19,36,15,0,Matches
133,134,Bruno Xavier Almeida Costa,pt POR,"MF,DF",Porto,24,1997,7.5,15,8,3,11,1,8,16,50.0,8,9,1,8,8,23,5,0,Matches
134,135,Diogo Costa,pt POR,GK,Porto,21,1999,33.0,0,0,0,0,0,0,0,,0,0,0,0,0,0,8,2,Matches
135,136,Edgar Costa,pt POR,"MF,FW",Marítimo,34,1987,14.4,21,14,6,12,3,8,20,40.0,12,10,2,8,6,27,5,1,Matches
136,137,Matheus Costa,br BRA,DF,Marítimo,26,1995,21.1,41,26,36,3,2,18,27,66.7,9,24,12,12,24,65,81,0,Matches
137,138,Murilo Costa,br BRA,"FW,MF",Gil Vicente FC,26,1994,9.4,13,5,5,7,1,6,15,40.0,9,10,0,10,8,21,7,0,Matches
138,139,Diogo Costa Rodrigues,pt POR,MF,Portimonense,21,1999,0.1,0,0,0,0,0,0,0,,0,0,0,0,0,0,0,0,Matches
139,140,Rui Costa,pt POR,FW,Santa Clara,25,1996,21.8,14,9,7,4,3,9,27,33.3,18,5,1,4,7,21,10,0,Matches
140,141,Tomás Costa Silva,pt POR,"FW,MF",FC Vizela,21,1999,0.4,1,1,1,0,0,0,0,,0,1,0,1,2,3,0,0,Matches
141,142,Vitor Costa,br BRA,DF,Marítimo,27,1994,28.4,100,63,60,37,3,57,95,60.0,38,35,9,26,46,146,78,1,Matches
142,143,Costinha,pt POR,FW,Santa Clara,28,1992,0.9,2,1,1,0,1,2,3,66.7,1,0,0,0,0,2,0,0,Matches
143,144,Filipe Couto,pt POR,MF,Marítimo,27,1994,0.2,0,0,0,0,0,0,0,,0,0,0,0,0,0,0,0,Matches
144,145,Yan Couto,br BRA,"DF,MF",Braga,19,2002,20.0,31,19,19,9,3,17,35,48.6,18,29,5,24,23,54,15,0,Matches
145,146,Crespo,pt POR,"MF,FW",Estoril,24,1996,2.9,9,4,3,6,0,4,8,50.0,4,5,2,3,2,11,2,0,Matches
146,147,Sandro Cruz,pt POR,DF,Benfica,20,2001,1.8,4,4,3,1,0,2,5,40.0,3,3,1,2,2,6,8,0,Matches
147,148,Crysan,br BRA,FW,Santa Clara,25,1996,15.9,23,17,4,13,6,11,29,37.9,18,25,4,21,7,30,13,0,Matches
148,149,Lucas Cunha,br BRA,DF,Gil Vicente FC,24,1997,32.0,14,8,8,6,0,9,14,64.3,5,31,24,7,29,43,124,4,Matches
149,150,Sessi D'Almeida,bj BEN,MF,Tondela,25,1995,2.4,6,5,0,5,1,2,3,66.7,1,4,1,3,3,9,2,0,Matches
150,151,Oday Dabbagh,ps PLE,"FW,MF",Arouca,22,1998,7.6,5,5,3,1,1,1,9,11.1,8,8,1,7,4,9,6,0,Matches
151,152,Julien Dacosta,fr FRA,"DF,MF",Portimonense,25,1996,4.4,12,7,7,4,1,7,12,58.3,5,6,3,3,2,14,11,0,Matches
152,153,Renat Dadaşov,az AZE,FW,Tondela,22,1999,16.0,9,2,3,2,4,3,13,23.1,10,18,3,15,4,13,18,0,Matches
153,154,Dalberson,br BRA,GK,Famalicão,24,1997,2.0,0,0,0,0,0,0,1,0.0,1,0,0,0,0,0,0,0,Matches
154,155,Daniel,br BRA,FW,Tondela,25,1996,17.7,11,5,4,3,4,6,18,33.3,12,12,2,10,2,13,21,0,Matches
155,156,Tiago Dantas,pt POR,MF,Tondela,20,2000,12.2,13,10,8,5,0,10,20,50.0,10,7,3,4,11,24,3,0,Matches
156,157,Or Dasa,il ISR,"MF,FW",Arouca,22,1998,0.6,0,0,0,0,0,0,2,0.0,2,0,0,0,0,0,1,0,Matches
157,158,Hernán De La Fuente,ar ARG,"DF,MF",Famalicão,24,1997,10.3,19,14,9,6,4,13,28,46.4,15,14,3,11,15,34,15,0,Matches
158,159,Juan Delgado,cl CHI,"DF,FW",Paços,28,1993,21.9,47,27,21,17,9,28,68,41.2,40,30,2,28,19,66,31,1,Matches
159,160,Denílson,br BRA,FW,Paços,26,1995,20.1,5,2,1,3,1,4,12,33.3,8,9,0,9,3,8,20,0,Matches
160,161,Jordan van der Gaag,nl NED,"MF,FW",B-SAD,22,1999,2.0,4,3,3,0,1,0,4,0.0,4,2,0,2,0,4,2,0,Matches
161,162,Lamine Diaby,fr FRA,"MF,FW",Paços,24,1996,2.5,12,6,5,7,0,6,9,66.7,3,7,2,5,10,22,10,0,Matches
162,163,Luis Díaz,co COL,"MF,FW",Porto,24,1997,16.6,12,5,2,6,4,5,13,38.5,8,11,0,11,4,16,6,0,Matches
163,164,Marcelo Djaló,gw GNB,DF,Boavista,27,1993,0.6,0,0,0,0,0,0,1,0.0,1,0,0,0,0,0,2,0,Matches
164,165,Matchoi Djaló,pt POR,"MF,FW",Paços,18,2003,7.9,12,7,2,8,2,5,14,35.7,9,9,1,8,2,14,2,0,Matches
165,166,Ivan Dolček,hr CRO,"DF,MF",Famalicão,21,2000,2.2,5,3,3,2,0,4,5,80.0,1,0,0,0,5,10,6,0,Matches
166,167,Bruno Duarte,br BRA,"FW,MF",Vitória,25,1996,11.2,6,4,1,4,1,1,8,12.5,7,4,0,4,4,10,15,0,Matches
167,168,Rodrigo Duarte,pt POR,FW,Sporting CP,16,2005,0.5,0,0,0,0,0,0,1,0.0,1,0,0,0,1,1,0,0,Matches
168,169,Marcus Edwards,eng ENG,"MF,FW",Sporting CP,22,1998,5.8,5,4,1,3,1,1,8,12.5,7,4,0,4,1,6,0,0,Matches
169,170,Marcus Edwards,eng ENG,FW,Vitória,22,1998,14.3,11,3,7,3,1,6,13,46.2,7,1,0,1,2,13,1,0,Matches
170,171,Ricardo Esgaio,pt POR,"DF,MF",Sporting CP,28,1993,16.3,39,27,18,16,5,20,47,42.6,27,25,5,20,14,53,22,0,Matches
171,172,Tiago Esgaio,pt POR,DF,Arouca,25,1995,10.2,13,7,7,6,0,5,14,35.7,9,18,3,15,12,25,20,0,Matches
172,173,Tiago Esgaio,pt POR,DF,Braga,25,1995,0.8,3,2,1,2,0,1,1,100.0,0,0,0,0,1,4,0,0,Matches
173,174,Dario Essugo,pt POR,MF,Sporting CP,16,2005,0.5,1,1,1,0,0,0,0,,0,0,0,0,4,5,0,0,Matches
174,175,Gonçalo Esteves,pt POR,"DF,FW",Sporting CP,17,2004,1.6,3,2,2,1,0,2,2,100.0,0,2,0,2,0,3,3,0,Matches
175,176,Luís Esteves,pt POR,MF,Vitória,23,1998,0.4,1,1,1,0,0,0,2,0.0,2,0,0,0,0,1,0,0,Matches
176,177,Paulo Estrela Moreira,pt POR,MF,Portimonense,22,1999,0.1,0,0,0,0,0,0,0,,0,0,0,0,0,0,0,0,Matches
177,178,Oscar Estupiñan,co COL,FW,Vitória,24,1996,24.1,12,7,1,4,7,2,15,13.3,13,16,2,14,2,14,21,0,Matches
178,179,Friday Etim,ng NGA,"FW,MF",FC Vizela,19,2002,0.2,1,0,0,0,1,0,0,,0,0,0,0,0,1,0,0,Matches
179,180,Stephen Eustáquio,ca CAN,MF,Porto,24,1996,1.0,5,5,2,1,2,5,5,100.0,0,2,1,1,3,8,1,1,Matches
180,181,Stephen Eustáquio,ca CAN,MF,Paços,24,1996,16.4,37,23,17,14,6,25,60,41.7,35,14,5,9,28,65,24,0,Matches
181,182,Evanilson,br BRA,FW,Porto,21,1999,22.5,22,17,2,9,11,6,13,46.2,7,22,1,21,5,27,13,0,Matches
182,183,Ewerton,br BRA,MF,Portimonense,28,1992,8.1,15,10,5,8,2,3,19,15.8,16,8,1,7,8,23,6,0,Matches
183,184,Fabiano,br BRA,"DF,MF",Braga,21,2000,15.8,38,25,18,14,6,21,30,70.0,9,13,3,10,23,61,40,0,Matches
184,185,Miguel Falé,pt POR,"FW,MF",Braga,17,2004,2.8,5,1,2,3,0,3,5,60.0,2,3,0,3,0,5,0,0,Matches
185,186,Zouhair Feddal,ma MAR,DF,Sporting CP,32,1989,11.2,10,5,8,2,0,5,11,45.5,6,8,4,4,12,22,31,0,Matches
186,187,Luiz Felipe,br BRA,GK,B-SAD,24,1997,32.0,0,0,0,0,0,0,0,,0,1,0,1,2,2,26,0,Matches
187,188,Volnei Feltes,br BRA,DF,Estoril,21,2000,1.7,0,0,0,0,0,0,1,0.0,1,5,3,2,2,2,9,0,Matches
188,189,Gedson Fernandes,pt POR,MF,Benfica,22,1999,0.6,4,2,2,0,2,1,2,50.0,1,0,0,0,1,5,3,0,Matches
189,190,Ivanildo Fernandes,pt POR,DF,FC Vizela,25,1996,15.1,18,13,15,3,0,10,14,71.4,4,13,7,6,11,29,73,0,Matches
190,191,Jorge Filipe Oliveira Fernandes,pt POR,DF,Vitória,24,1997,13.6,32,21,22,9,1,21,31,67.7,10,17,8,9,21,53,55,0,Matches
191,192,Lucas Fernandes,br BRA,MF,Portimonense,23,1997,15.8,17,7,8,8,1,7,27,25.9,20,13,2,11,12,29,4,0,Matches
192,193,Ricardo Fernandes,pt POR,GK,Santa Clara,26,1994,5.9,0,0,0,0,0,0,1,0.0,1,0,0,0,0,0,3,1,Matches
193,194,Roger Fernandes,gw GNB,"MF,DF",Braga,15,2005,1.3,1,0,0,1,0,0,6,0.0,6,2,0,2,2,3,2,0,Matches
194,195,Rúben Fernandes,pt POR,DF,Gil Vicente FC,35,1986,32.8,5,3,3,2,0,3,8,37.5,5,27,24,3,30,35,124,2,Matches
195,196,Fernando,br BRA,FW,Porto,28,1993,0.1,0,0,0,0,0,0,0,,0,0,0,0,0,0,0,0,Matches
196,197,Nahuel Ferraresi,ve VEN,DF,Estoril,22,1998,22.1,44,22,30,13,1,21,34,61.8,13,21,10,11,30,74,79,2,Matches
197,198,André Ferreira,pt POR,GK,Paços,25,1996,32.0,4,2,4,0,0,4,4,100.0,0,0,0,0,1,5,14,1,Matches
198,199,Filipe Ferreira,pt POR,"DF,MF",Boavista,30,1990,15.8,19,11,10,5,4,8,24,33.3,16,21,5,16,27,46,33,0,Matches
199,200,Fernando Ferreira Fonseca,pt POR,DF,Paços,24,1997,16.6,28,13,12,11,5,21,39,53.8,18,8,2,6,27,55,35,0,Matches
200,201,Hélder Ferreira,pt POR,"FW,MF",Paços,24,1997,17.5,24,13,10,7,7,13,24,54.2,11,18,3,15,11,35,16,1,Matches
201,202,João Ferreira,pt POR,DF,Vitória,20,2001,10.9,22,13,11,9,2,10,24,41.7,14,17,7,10,17,39,36,0,Matches
202,203,Joel Ferreira,pt POR,DF,Arouca,29,1992,0.5,0,0,0,0,0,0,0,,0,0,0,0,2,2,1,0,Matches
203,204,Diogo Figueiras,pt POR,DF,Famalicão,30,1991,14.1,40,26,19,15,6,25,46,54.3,21,18,4,14,18,58,21,0,Matches
204,205,Tiago Fonseca Morais,pt POR,"MF,FW",Boavista,17,2003,3.4,4,1,1,2,1,1,9,11.1,8,2,0,2,3,7,0,1,Matches
205,206,Rui Fonte,pt POR,FW,Estoril,31,1990,14.2,11,8,1,7,3,6,18,33.3,12,4,1,3,5,16,22,0,Matches
206,207,Rui Fonte,pt POR,DF,Braga,31,1990,0.1,2,2,0,2,0,0,0,,0,1,0,1,0,2,0,0,Matches
207,208,André Franco,pt POR,MF,Estoril,23,1998,28.0,34,19,13,15,6,15,30,50.0,15,18,2,16,16,50,30,0,Matches
208,209,Gonçalo Franco,pt POR,MF,Moreirense,20,2000,12.7,28,17,17,7,4,7,21,33.3,14,21,2,19,16,44,8,0,Matches
209,210,Fransérgio,br BRA,MF,Braga,30,1990,1.6,1,1,0,1,0,0,1,0.0,1,2,1,1,1,2,1,0,Matches
210,211,Žiga Frelih,si SVN,GK,Gil Vicente FC,23,1998,19.0,0,0,0,0,0,0,0,,0,0,0,0,3,3,12,0,Matches
211,212,Godfried Frimpong,nl NED,"DF,MF",Moreirense,22,1999,6.5,11,7,5,5,1,6,6,100.0,0,10,3,7,9,20,16,0,Matches
212,213,Kanya Fujimoto,jp JPN,"MF,FW",Gil Vicente FC,22,1999,26.6,22,12,4,15,3,7,20,35.0,13,25,9,16,10,32,10,0,Matches
213,214,Rodolfo Furtado,pt POR,GK,Santa Clara,23,1997,0.1,0,0,0,0,0,0,0,,0,0,0,0,0,0,0,0,Matches
214,215,Nicolás Gaitán,ar ARG,MF,Paços,33,1988,3.3,8,5,3,3,2,3,11,27.3,8,0,0,0,0,8,2,0,Matches
215,216,Jefferson Galego,br BRA,"MF,FW",Moreirense,24,1997,1.0,3,2,1,1,1,3,4,75.0,1,3,0,3,1,4,1,0,Matches
216,217,Galeno,br BRA,"MF,FW",Porto,23,1997,3.5,3,3,0,1,2,1,5,20.0,4,6,0,6,2,5,5,0,Matches
217,218,Galeno,br BRA,"MF,DF",Braga,23,1997,10.6,22,14,8,11,3,13,27,48.1,14,10,1,9,9,31,9,1,Matches
218,219,Nino Galović,hr CRO,DF,Arouca,29,1992,10.3,6,5,5,1,0,2,5,40.0,3,7,4,3,15,21,47,0,Matches
219,220,João Gamboa,pt POR,MF,Estoril,24,1996,23.5,22,11,5,14,3,9,24,37.5,15,44,27,17,38,60,61,1,Matches
220,221,Pedro Ganchas,pt POR,DF,Paços,21,2000,1.6,0,0,0,0,0,0,0,,0,0,0,0,5,5,5,0,Matches
221,222,Javi García,es ESP,"DF,MF",Boavista,34,1987,13.8,10,4,6,4,0,5,10,50.0,5,10,10,0,19,29,35,0,Matches
222,223,Geovani,br BRA,"FW,MF",Famalicão,20,2001,0.8,8,6,6,1,1,6,8,75.0,2,1,0,1,0,8,0,0,Matches
223,224,Francisco Geraldes,pt POR,MF,Estoril,26,1995,18.2,30,14,11,12,7,19,41,46.3,22,17,3,14,14,44,10,0,Matches
224,225,Gilberto,br BRA,"DF,MF",Benfica,28,1993,15.0,48,30,28,14,6,33,43,76.7,10,23,3,20,20,68,30,1,Matches
225,226,Henrique Gomes,pt POR,DF,Gil Vicente FC,25,1995,2.6,3,2,2,1,0,1,1,100.0,0,2,2,0,2,5,7,0,Matches
226,227,Rodrigo Gomes,pt POR,"MF,DF",Braga,18,2003,8.2,13,7,7,4,2,8,16,50.0,8,11,0,11,6,19,9,0,Matches
227,228,Sana Gomes,gw GNB,DF,Portimonense,19,2002,4.1,10,4,8,2,0,7,11,63.6,4,3,1,2,0,10,10,0,Matches
228,229,Luis Gómez,co COL,"MF,FW",Santa Clara,21,1999,0.7,2,0,1,0,1,1,2,50.0,1,2,1,1,0,2,0,0,Matches
229,230,Nuno Gonçalo Moreira,pt POR,FW,FC Vizela,22,1999,18.8,32,17,13,15,4,11,37,29.7,26,15,2,13,20,52,15,0,Matches
230,231,Diogo Gonçalves,pt POR,"MF,FW",Benfica,24,1997,9.6,14,11,6,5,3,6,12,50.0,6,16,1,15,5,19,4,0,Matches
231,232,Ivo Gonçalves,pt POR,GK,FC Vizela,37,1984,1.0,0,0,0,0,0,0,0,,0,0,0,0,0,0,0,0,Matches
232,233,Jota Gonçalves,pt POR,DF,Tondela,21,2000,4.1,6,3,6,0,0,5,7,71.4,2,6,2,4,3,9,18,0,Matches
233,234,Pedro Gonçalves,pt POR,"MF,FW",Sporting CP,23,1998,22.4,29,16,10,10,9,12,41,29.3,29,15,2,13,14,43,2,0,Matches
234,235,Cristian González,uy URU,DF,Santa Clara,25,1996,14.9,21,14,16,4,1,12,20,60.0,8,13,9,4,20,41,60,0,Matches
235,236,Mario González,es ESP,FW,Braga,25,1996,6.2,1,0,0,1,0,1,7,14.3,6,5,2,3,0,1,2,0,Matches
236,237,Jean Gorby,fr FRA,MF,Braga,19,2002,2.3,5,2,3,1,1,2,5,40.0,3,2,0,2,2,7,2,0,Matches
237,238,Kenji Gorré,cw CUW,"FW,MF",Boavista,26,1994,18.5,22,8,7,13,2,12,20,60.0,8,13,1,12,8,30,6,0,Matches
238,239,Tiago Gouveia,pt POR,"FW,MF",Benfica,20,2001,1.0,2,1,0,2,0,1,4,25.0,3,1,0,1,2,4,1,0,Matches
239,240,Álex Grimaldo,es ESP,"DF,MF",Benfica,25,1995,25.8,50,36,27,17,6,28,53,52.8,25,29,6,23,29,79,35,0,Matches
240,241,Marko Grujić,rs SRB,MF,Porto,25,1996,9.9,27,15,9,14,4,19,34,55.9,15,11,2,9,16,43,16,0,Matches
241,242,Gui Guedes,pt POR,MF,Vitória,19,2002,0.7,3,1,2,1,0,1,3,33.3,2,2,0,2,0,3,1,0,Matches
242,243,Rafik Guitane,fr FRA,"FW,MF",Marítimo,22,1999,21.2,19,12,7,7,5,9,22,40.9,13,20,0,20,6,25,2,0,Matches
243,244,Raphael Guzzo,pt POR,MF,FC Vizela,26,1995,9.1,12,4,5,4,3,6,18,33.3,12,11,3,8,10,22,18,0,Matches
244,245,Emmanuel Hackman,tg TOG,DF,Gil Vicente FC,26,1995,7.4,11,6,4,7,0,4,12,33.3,8,11,6,5,11,22,26,0,Matches
245,246,Yanis Hamache,dz ALG,"MF,DF",Boavista,22,1999,20.5,35,21,20,13,2,14,33,42.4,19,25,6,19,22,57,41,1,Matches
246,247,Tomás Händel,pt POR,MF,Vitória,20,2000,11.5,10,4,2,8,0,6,20,30.0,14,9,2,7,13,23,17,0,Matches
247,248,Boubacar Hanne,pt POR,"FW,MF",Gil Vicente FC,22,1999,2.8,5,4,2,3,0,0,5,0.0,5,2,0,2,0,5,1,0,Matches
248,249,Norbert Haymamba,cm CMR,GK,Arouca,22,1999,3.0,0,0,0,0,0,0,2,0.0,2,0,0,0,0,0,3,1,Matches
249,250,Henrique,br BRA,"FW,MF",Marítimo,27,1993,8.9,16,13,10,4,2,3,13,23.1,10,15,0,15,14,30,5,0,Matches
250,251,Danny Henriques,nl NED,DF,B-SAD,24,1997,21.9,15,9,13,2,0,8,20,40.0,12,32,21,11,24,39,77,2,Matches
251,252,Manu Hernando,es ESP,DF,Tondela,23,1998,17.8,13,9,10,2,1,5,12,41.7,7,15,11,4,30,43,78,0,Matches
252,253,Lukáš Horníček,cz CZE,GK,Braga,19,2002,1.0,0,0,0,0,0,0,0,,0,0,0,0,0,0,1,0,Matches
253,254,André Horta,pt POR,MF,Braga,24,1996,17.4,29,14,9,14,6,11,41,26.8,30,15,2,13,7,36,4,1,Matches
254,255,Ricardo Horta,pt POR,"FW,MF",Braga,26,1994,31.0,43,28,15,13,15,19,58,32.8,39,29,1,28,13,56,8,0,Matches
255,256,Abbas Ibrahim,ng NGA,"MF,FW",Paços,23,1998,2.0,6,3,2,4,0,2,5,40.0,3,3,2,1,3,9,2,2,Matches
256,257,Abdulwahab Ibrahim,gh GHA,MF,Famalicão,22,1999,0.0,0,0,0,0,0,0,0,,0,0,0,0,0,0,0,0,Matches
257,258,Tiago Ilori,pt POR,DF,Boavista,28,1993,5.6,4,3,4,0,0,2,4,50.0,2,5,4,1,15,19,28,0,Matches
258,259,Giannelli Imbula,cd COD,"MF,FW",Portimonense,28,1992,1.5,6,3,2,3,1,4,5,80.0,1,2,0,2,0,6,0,0,Matches
259,260,Gonçalo Inácio,pt POR,DF,Sporting CP,19,2001,27.5,38,18,24,13,1,19,29,65.5,10,17,11,6,26,64,68,1,Matches
260,261,Ivan Jaime Pajuelo,es ESP,"MF,FW",Famalicão,20,2000,14.0,12,6,0,8,4,5,13,38.5,8,11,1,10,11,23,5,1,Matches
261,262,Nikola Jambor,hr CRO,MF,Moreirense,25,1995,1.1,0,0,0,0,0,0,1,0.0,1,1,0,1,1,1,0,0,Matches
262,263,Nicolas Janvier,fr FRA,MF,Vitória,22,1998,12.1,17,13,3,12,2,11,23,47.8,12,12,2,10,11,28,10,0,Matches
263,264,Jean,br BRA,MF,Gil Vicente FC,26,1994,0.1,2,2,2,0,0,1,2,50.0,1,1,0,1,0,2,1,0,Matches
264,265,Jefferson,br BRA,MF,Moreirense,27,1994,11.0,20,15,10,9,1,11,22,50.0,11,7,1,6,11,31,7,1,Matches
265,266,Jeimes,br BRA,GK,Paços,20,2001,1.9,0,0,0,0,0,0,1,0.0,1,0,0,0,0,0,4,1,Matches
266,267,Anderson Jesus,br BRA,DF,FC Vizela,26,1995,17.0,13,11,11,2,0,10,19,52.6,9,18,13,5,28,41,76,1,Matches
267,268,Joãozinho,pt POR,DF,Estoril,32,1989,32.1,47,33,27,13,7,28,46,60.9,18,36,14,22,30,77,67,0,Matches
268,269,Henrique Jocú,pt POR,MF,Portimonense,19,2001,6.6,14,6,5,8,1,7,16,43.8,9,4,0,4,3,17,4,0,Matches
269,270,Diederrick Joel,cm CMR,FW,Marítimo,27,1993,16.9,13,5,3,9,1,3,11,27.3,8,15,0,15,8,21,16,0,Matches
270,271,Jójó,cv CPV,DF,B-SAD,20,2001,0.5,2,0,1,1,0,0,2,0.0,2,1,1,0,1,3,2,0,Matches
271,272,Igor Julião,br BRA,DF,FC Vizela,26,1994,11.1,19,11,12,3,4,12,17,70.6,5,10,1,9,9,28,18,0,Matches
272,273,Luiz Lúcio Reis Júnior,br BRA,GK,Famalicão,20,2001,31.0,1,0,1,0,0,1,3,33.3,2,0,0,0,0,1,33,2,Matches
273,274,Renato Junior,br BRA,FW,Portimonense,19,2002,3.8,2,1,0,1,1,1,4,25.0,3,7,0,7,0,2,3,0,Matches
274,275,Welinton Júnior,br BRA,FW,Portimonense,28,1993,9.3,4,3,3,0,1,2,7,28.6,5,2,1,1,6,10,6,0,Matches
275,276,Zainadine Júnior,mz MOZ,DF,Marítimo,33,1988,31.8,35,24,26,8,1,18,25,72.0,7,40,34,6,55,90,130,1,Matches
276,277,Junior Kadile,fr FRA,"MF,FW",Famalicão,18,2002,0.5,0,0,0,0,0,0,0,,0,0,0,0,1,1,1,0,Matches
277,278,Eduardo Kau,br BRA,DF,B-SAD,22,1999,1.0,0,0,0,0,0,0,0,,0,1,1,0,0,0,4,1,Matches
278,279,Kewin,br BRA,GK,Moreirense,25,1995,15.0,1,1,1,0,0,1,1,100.0,0,0,0,0,0,1,13,1,Matches
279,280,Hamidou Keyta,fr FRA,"FW,MF",Santa Clara,26,1994,0.8,1,0,0,0,1,0,2,0.0,2,2,0,2,0,1,1,0,Matches
280,281,Naoufel Khacef,dz ALG,"DF,FW",Tondela,23,1997,9.6,17,10,10,5,2,9,22,40.9,13,4,0,4,14,31,16,0,Matches
281,282,Kobamelo Kodisang,za RSA,FW,Braga,21,1999,0.2,0,0,0,0,0,0,0,,0,0,0,0,0,0,0,0,Matches
282,283,Philippe Koffi,fr FRA,FW,Paços,19,2002,0.3,0,0,0,0,0,0,0,,0,0,0,0,0,0,0,0,Matches
283,284,Koffi Kouao,ci CIV,DF,FC Vizela,23,1998,21.0,57,39,41,11,5,35,53,66.0,18,12,1,11,39,96,47,0,Matches
284,285,Eboue Kouassi,ci CIV,MF,Arouca,23,1997,16.3,20,11,8,12,0,11,20,55.0,9,12,4,8,12,32,30,1,Matches
285,286,Stanislav Kritsyuk,ru RUS,GK,Gil Vicente FC,30,1990,4.0,0,0,0,0,0,0,0,,0,0,0,0,0,0,2,0,Matches
286,287,Matías Lacava,ve VEN,"FW,MF",Tondela,18,2002,0.2,4,4,3,1,0,2,2,100.0,0,0,0,0,2,6,0,0,Matches
287,288,Derik Lacerda,br BRA,"FW,MF",Moreirense,21,1999,8.7,20,14,9,6,5,6,15,40.0,9,12,2,10,7,27,8,0,Matches
288,289,Rúben Lameiras,pt POR,"FW,MF",Vitória,26,1994,17.0,20,11,10,8,2,13,28,46.4,15,15,0,15,5,25,6,0,Matches
289,290,Achraf Lazaar,ma MAR,DF,Portimonense,29,1992,2.7,7,6,6,0,1,3,7,42.9,4,2,1,1,5,12,14,0,Matches
290,291,Valentino Lazaro,at AUT,"DF,MF",Benfica,25,1996,11.4,13,9,4,7,2,8,17,47.1,9,17,2,15,11,24,14,0,Matches
291,292,Antoine Léautey,fr FRA,FW,Gil Vicente FC,25,1996,16.2,14,9,2,9,3,5,15,33.3,10,12,0,12,10,24,1,0,Matches
292,293,Daniel Leite,pt POR,GK,Estoril,23,1998,24.0,0,0,0,0,0,0,0,,0,0,0,0,0,0,6,2,Matches
293,294,Diogo Leite,pt POR,DF,Braga,22,1999,20.6,29,20,17,11,1,16,26,61.5,10,30,15,15,31,60,70,1,Matches
294,295,Helton Leite,br BRA,GK,Benfica,30,1990,2.0,0,0,0,0,0,0,0,,0,0,0,0,0,0,2,0,Matches
295,296,André Filipe Rio Liberal,pt POR,FW,Gil Vicente FC,18,2002,0.1,0,0,0,0,0,0,0,,0,1,0,1,0,0,0,0,Matches
296,297,Licá,pt POR,"FW,DF",B-SAD,32,1988,4.6,3,1,1,1,1,1,7,14.3,6,5,0,5,3,6,3,0,Matches
297,298,Nuno Lima,pt POR,DF,Paços,20,2001,10.8,20,11,17,3,0,15,28,53.6,13,16,10,6,13,33,44,1,Matches
298,299,Rúben Lima,pt POR,"DF,MF",Famalicão,31,1989,6.1,12,5,6,6,0,3,7,42.9,4,3,1,2,13,25,17,0,Matches
299,300,Lincoln,br BRA,MF,Santa Clara,22,1998,30.5,30,20,11,18,1,14,36,38.9,22,29,3,26,14,44,26,2,Matches
300,301,Danny Loader,eng ENG,"FW,MF",Porto,20,2000,0.1,,0,,,,,,,,,,,0,,,,Matches
301,302,André Lopes,pt POR,DF,B-SAD,19,2001,1.0,0,0,0,0,0,0,0,,0,0,0,0,0,0,2,0,Matches
302,303,Bruno Lourenço,pt POR,"FW,MF",Estoril,23,1998,12.7,8,3,2,4,2,5,22,22.7,17,3,0,3,3,11,10,1,Matches
303,304,André Luis,br BRA,"FW,MF",Moreirense,27,1994,14.8,8,5,0,4,4,2,13,15.4,11,15,1,14,2,10,17,0,Matches
304,305,Andrija Luković,rs SRB,MF,B-SAD,26,1994,9.9,14,7,5,7,2,6,17,35.3,11,8,4,4,14,28,10,0,Matches
305,306,Luquinha,br BRA,"MF,FW",Portimonense,20,2000,6.1,9,6,4,3,2,5,17,29.4,12,8,0,8,3,12,0,0,Matches
306,307,Rúben Macedo,pt POR,"FW,DF",Marítimo,25,1996,0.7,2,2,2,0,0,0,1,0.0,1,0,0,0,0,2,1,0,Matches
307,308,Maga,pt POR,DF,Vitória,22,1999,12.0,,17,,,,,,,,,,,19,,,,Matches
308,309,Gaius Makouta,cg CGO,MF,Boavista,24,1997,28.0,45,27,20,22,3,21,46,45.7,25,18,4,14,35,80,31,1,Matches
309,310,Pedro Malheiro,pt POR,"MF,DF",Boavista,20,2001,9.9,27,14,20,4,3,19,29,65.5,10,13,0,13,30,57,16,0,Matches
310,311,Wilson Manafá,pt POR,DF,Porto,27,1994,2.9,6,3,3,2,1,4,6,66.7,2,3,1,2,2,8,7,0,Matches
311,312,Sori Mané,gw GNB,MF,Moreirense,25,1996,5.5,9,5,3,5,1,7,17,41.2,10,4,1,3,4,13,11,0,Matches
312,313,Mansur,br BRA,DF,Santa Clara,28,1993,22.1,34,18,27,5,2,20,36,55.6,16,27,8,19,37,71,62,1,Matches
313,314,Juan Manuel Boselli,uy URU,"FW,MF",Tondela,21,1999,9.5,10,7,5,3,2,3,9,33.3,6,10,1,9,3,13,6,0,Matches
314,315,José Manuel Velázquez,ve VEN,DF,Arouca,30,1990,4.0,7,2,5,2,0,5,9,55.6,4,4,0,4,11,18,17,0,Matches
315,316,Maracás,br BRA,DF,Paços,27,1994,23.0,34,21,28,6,0,17,36,47.2,19,34,19,15,53,87,108,0,Matches
316,317,Iván Marcano,es ESP,DF,Porto,34,1987,7.3,9,7,6,2,1,4,6,66.7,2,3,3,0,10,19,22,0,Matches
317,318,Marcelo,br BRA,"FW,MF",Gil Vicente FC,24,1997,0.1,0,0,0,0,0,0,0,,0,0,0,0,0,0,0,0,Matches
318,319,Agustín Marchesín,ar ARG,GK,Porto,33,1988,0.0,0,0,0,0,0,0,0,,0,0,0,0,0,0,0,0,Matches
319,320,Abraham Marcus,ng NGA,FW,Portimonense,21,2000,0.9,0,0,0,0,0,0,1,0.0,1,2,0,2,1,1,2,0,Matches
320,321,Adrián Marín,es ESP,"DF,MF",Famalicão,24,1997,25.5,39,22,18,14,7,19,25,76.0,6,17,8,9,42,81,60,3,Matches
321,322,João Mário,pt POR,MF,Benfica,28,1993,19.3,38,22,12,18,8,17,33,51.5,16,12,3,9,15,53,2,1,Matches
322,323,João Mário Lopes,pt POR,DF,Porto,21,2000,22.9,41,28,16,21,4,26,60,43.3,34,25,1,24,28,69,23,0,Matches
323,324,Pedro David Rosendo Marques,pt POR,"FW,MF",Famalicão,23,1998,3.5,1,1,1,0,0,1,3,33.3,2,3,0,3,0,1,1,0,Matches
324,325,José Marsà,es ESP,DF,Sporting CP,19,2002,0.1,0,0,0,0,0,0,0,,0,0,0,0,0,0,0,0,Matches
325,326,Toni Martínez,es ESP,FW,Porto,24,1997,5.3,3,1,0,2,1,1,3,33.3,2,5,0,5,0,3,5,0,Matches
326,327,Fábio Martins,pt POR,"MF,FW",Braga,28,1993,4.6,6,3,2,4,0,1,7,14.3,6,4,0,4,2,8,5,0,Matches
327,328,Rafael Martins,br BRA,FW,Moreirense,32,1989,26.6,14,9,4,8,2,7,17,41.2,10,14,2,12,2,16,21,0,Matches
328,329,Matheus,br BRA,GK,Braga,29,1992,32.0,1,0,1,0,0,1,3,33.3,2,0,0,0,1,2,15,1,Matches
329,330,Ricardo Matos,pt POR,"FW,MF",Portimonense,21,2000,2.5,1,0,1,0,0,0,0,,0,0,0,0,1,2,3,0,Matches
330,331,Emmanuel Maviram,ng NGA,DF,FC Vizela,20,2001,0.3,1,1,1,0,0,0,0,,0,0,0,0,1,2,1,0,Matches
331,332,Chancel Mbemba,cd COD,DF,Porto,26,1994,30.9,25,15,16,8,1,13,17,76.5,4,16,11,5,25,50,83,1,Matches
332,333,Jordi Mboula,es ESP,"FW,MF",Estoril,22,1999,10.7,11,4,5,5,1,3,13,23.1,10,11,3,8,8,19,2,1,Matches
333,334,Iuri Medeiros,pt POR,"MF,FW",Braga,27,1994,15.8,17,13,1,10,6,3,15,20.0,12,20,3,17,8,25,0,0,Matches
334,335,Soualiho Meïté,fr FRA,MF,Benfica,27,1994,9.8,14,5,1,10,3,6,13,46.2,7,10,5,5,13,27,8,0,Matches
335,336,Francisco Meixedo,pt POR,GK,Porto,20,2001,0.0,0,0,0,0,0,0,0,,0,0,0,0,0,0,0,0,Matches
336,337,Tiago Melo Almeida,pt POR,"DF,MF",Tondela,19,2001,20.6,43,28,22,19,2,24,37,64.9,13,16,6,10,26,69,45,0,Matches
337,338,Diogo Mendes,pt POR,MF,Marítimo,23,1998,20.4,41,22,12,23,6,14,40,35.0,26,27,7,20,27,68,17,1,Matches
338,339,Edmilson Mendes,gw GNB,"FW,MF",Paços,18,2003,0.2,0,0,0,0,0,0,0,,0,0,0,0,0,0,0,0,Matches
339,340,Nuno Mendes,pt POR,DF,Sporting CP,19,2002,1.3,3,2,0,2,1,2,4,50.0,2,1,0,1,1,4,1,0,Matches
340,341,Alexis Méndez,us USA,"MF,FW",FC Vizela,20,2000,16.1,27,12,12,12,3,10,26,38.5,16,5,1,4,13,40,9,0,Matches
341,342,Ryotaro Meshino,jp JPN,"FW,MF",Estoril,23,1998,1.3,3,1,2,1,0,1,4,25.0,3,1,0,1,0,3,0,0,Matches
342,343,Fabrício dos Santos Messias,br BRA,"FW,MF",Portimonense,31,1990,14.8,10,7,3,5,2,3,10,30.0,7,9,2,7,2,12,12,0,Matches
343,344,João Miguel,pt POR,DF,Porto,21,2000,0.1,0,0,0,0,0,0,1,0.0,1,0,0,0,0,0,0,0,Matches
344,345,Milson,ao ANG,MF,Marítimo,21,1999,0.2,2,1,0,1,1,0,0,,0,0,0,0,0,2,0,0,Matches
345,346,Lucas Mineiro,br BRA,MF,Braga,25,1996,6.2,10,5,0,9,1,3,10,30.0,7,8,1,7,2,12,9,0,Matches
346,347,Kevin Mirallas,be BEL,"FW,MF",Moreirense,33,1987,3.3,3,1,1,2,0,0,2,0.0,2,1,0,1,1,4,0,0,Matches
347,348,Mohammad Mohebbi,ir IRN,"FW,MF",Santa Clara,22,1998,5.0,9,8,4,3,2,3,7,42.9,4,3,2,1,3,12,4,0,Matches
348,349,João Monteiro,pt POR,MF,B-SAD,20,2001,1.0,1,1,1,0,0,1,1,100.0,0,0,0,0,0,1,1,0,Matches
349,350,António Montez,pt POR,MF,B-SAD,19,2001,1.0,1,1,1,0,0,1,1,100.0,0,1,1,0,0,1,7,0,Matches
350,351,Morato,br BRA,DF,Benfica,20,2001,11.2,14,10,5,6,3,8,15,53.3,7,18,13,5,8,22,34,0,Matches
351,352,Diego Moreira,pt POR,FW,Benfica,16,2004,0.3,0,0,0,0,0,0,0,,0,0,0,0,1,1,0,0,Matches
352,353,Pedro Filipe Barbosa Moreira,pt POR,MF,Gil Vicente FC,28,1992,32.0,68,38,22,37,9,25,63,39.7,38,23,5,18,28,96,22,2,Matches
353,354,Hidemasa Morita,jp JPN,MF,Santa Clara,26,1995,25.3,38,18,14,23,1,16,37,43.2,21,27,5,22,45,83,34,0,Matches
354,355,Mosquito,br BRA,GK,Estoril,25,1996,10.0,0,0,0,0,0,0,0,,0,0,0,0,0,0,2,2,Matches
355,356,Luís Mota,pt POR,"FW,MF",B-SAD,17,2003,1.2,2,1,0,1,1,0,2,0.0,2,2,0,2,2,4,0,0,Matches
356,357,Fahd Moufi,ma MAR,DF,Portimonense,25,1996,30.6,35,24,20,8,7,16,32,50.0,16,50,22,28,51,86,66,1,Matches
357,358,Moura,pt POR,"DF,MF",Braga,21,1999,16.5,26,19,11,11,4,13,28,46.4,15,25,1,24,18,44,32,0,Matches
358,359,Abdul Mumin,gh GHA,DF,Vitória,23,1998,24.7,34,25,20,13,1,17,24,70.8,7,23,17,6,34,68,100,1,Matches
359,360,Simone Muratore,it ITA,MF,Tondela,23,1998,0.3,2,2,0,2,0,2,3,66.7,1,1,1,0,0,2,2,0,Matches
360,361,Jhon Murillo,ve VEN,"FW,MF",Tondela,26,1995,11.9,,7,,,,,,,,,,,2,,,,Matches
361,362,Petar Musa,hr CRO,FW,Boavista,23,1998,25.7,14,10,2,7,5,8,18,44.4,10,16,3,13,4,18,35,0,Matches
362,363,Herculano Nabian,pt POR,FW,Vitória,17,2004,0.7,0,0,0,0,0,0,0,,0,0,0,0,0,0,0,0,Matches
363,364,Shoya Nakajima,jp JPN,"MF,FW",Portimonense,26,1994,19.6,20,11,5,11,4,7,19,36.8,12,7,2,5,4,24,2,0,Matches
364,365,Kosuke Nakamura,jp JPN,GK,Portimonense,26,1995,2.0,0,0,0,0,0,0,0,,0,0,0,0,0,0,1,0,Matches
365,366,Manuel Namora,pt POR,"MF,DF",Boavista,23,1998,0.2,0,0,0,0,0,0,2,0.0,2,0,0,0,2,2,0,0,Matches
366,367,Bruno Nascimento,br BRA,"FW,MF",Famalicão,24,1997,21.7,35,21,15,11,9,18,40,45.0,22,30,0,30,16,51,14,0,Matches
367,368,Nathan,br BRA,"DF,MF",Boavista,19,2001,25.8,59,38,30,22,7,30,68,44.1,38,19,4,15,25,84,50,0,Matches
368,369,Fran Navarro,es ESP,FW,Gil Vicente FC,23,1998,28.9,19,8,6,9,4,4,28,14.3,24,21,1,20,4,23,15,0,Matches
369,370,Flávio Nazinho,pt POR,"DF,MF",Sporting CP,18,2003,1.1,0,0,0,0,0,0,1,0.0,1,1,0,1,0,0,0,0,Matches
370,371,Alioune Ndour,sn SEN,FW,B-SAD,20,2001,9.2,6,3,0,3,3,3,5,60.0,2,5,1,4,2,8,4,0,Matches
371,372,Christian Neiva Afonso,pt POR,DF,FC Vizela,26,1994,19.9,49,36,31,15,3,31,49,63.3,18,23,7,16,32,81,58,1,Matches
372,373,Nelson,ao ANG,"FW,MF",Vitória,23,1998,3.8,6,4,4,2,0,0,0,,0,6,0,6,2,8,2,0,Matches
373,374,Wellington Nem,br BRA,DF,Arouca,29,1992,0.0,0,0,0,0,0,0,0,,0,0,0,0,0,0,0,0,Matches
374,375,João Neto,br BRA,"MF,FW",Famalicão,18,2003,0.7,1,1,1,0,0,1,1,100.0,0,0,0,0,0,1,0,0,Matches
375,376,Luís Neto,pt POR,DF,Sporting CP,33,1988,15.5,27,18,20,7,0,14,27,51.9,13,11,6,5,23,50,40,0,Matches
376,377,Babacar Niasse,mr MTN,GK,Tondela,24,1996,5.1,0,0,0,0,0,0,0,,0,0,0,0,0,0,6,0,Matches
377,378,Payam Niazmand,ir IRN,GK,Portimonense,26,1995,2.0,0,0,0,0,0,0,0,,0,0,0,0,0,0,1,1,Matches
378,379,Yusupha Njie,gm GAM,"FW,MF",Boavista,27,1994,17.4,17,8,4,12,1,6,31,19.4,25,23,1,22,4,21,15,0,Matches
379,380,Paul-Georges Ntep,cm CMR,"FW,MF",Boavista,29,1992,5.6,5,4,1,2,2,2,8,25.0,6,9,2,7,1,6,4,0,Matches
380,381,Arsénio Martins Lafuente Nunes,pt POR,"FW,MF",Arouca,31,1989,24.3,26,17,5,16,5,10,32,31.3,22,17,2,15,14,40,12,0,Matches
381,382,Matheus Nunes,pt POR,MF,Sporting CP,22,1998,28.4,42,23,17,21,4,15,38,39.5,23,23,2,21,29,71,22,1,Matches
382,383,Darwin Núñez,uy URU,"FW,MF",Benfica,22,1999,22.0,14,7,5,5,4,3,10,30.0,7,13,5,8,5,19,15,0,Matches
383,384,Pedro Nuno,pt POR,"MF,FW",B-SAD,26,1995,15.8,13,8,3,5,5,2,16,12.5,14,16,4,12,8,21,8,0,Matches
384,385,Lawrence Ofori,gh GHA,MF,Famalicão,23,1998,1.7,4,2,1,1,2,3,7,42.9,4,0,0,0,4,8,0,0,Matches
385,386,Richard Ofori,gh GHA,DF,FC Vizela,28,1993,19.0,40,27,32,6,2,22,47,46.8,25,15,2,13,44,84,38,1,Matches
386,387,Thales Oleques,br BRA,DF,Arouca,27,1994,30.2,68,43,29,34,5,44,81,54.3,37,40,11,29,50,118,71,1,Matches
387,388,Hugo Oliveira,pt POR,DF,FC Vizela,19,2002,0.1,0,0,0,0,0,0,0,,0,0,0,0,0,0,0,0,Matches
388,389,Paulo Oliveira,pt POR,DF,Braga,29,1992,26.1,35,24,25,10,0,15,30,50.0,15,23,11,12,53,88,104,1,Matches
389,390,Rúben Alexandre Gomes Oliveira,pt POR,"MF,FW",Santa Clara,26,1994,2.1,6,3,1,4,1,3,5,60.0,2,4,1,3,0,6,3,0,Matches
390,391,Sérgio Oliveira,pt POR,MF,Porto,29,1992,4.4,19,14,4,10,5,7,21,33.3,14,5,1,4,4,23,3,0,Matches
391,392,Nicolás Otamendi,ar ARG,DF,Benfica,33,1988,27.4,54,31,42,10,2,35,55,63.6,20,24,11,13,59,113,70,1,Matches
392,393,Otávio,pt POR,"MF,FW",Porto,26,1995,29.5,100,60,22,46,32,42,85,49.4,43,32,3,29,21,121,16,0,Matches
393,394,João Othavio Basso,br BRA,DF,Arouca,24,1997,32.5,61,45,43,14,4,35,49,71.4,14,26,12,14,44,105,147,0,Matches
394,395,Pablo,br BRA,FW,Famalicão,17,2004,2.0,5,2,1,1,3,3,4,75.0,1,2,0,2,0,5,2,0,Matches
395,396,Fábio Pacheco,pt POR,MF,Moreirense,33,1988,20.6,61,30,26,30,5,26,66,39.4,40,33,9,24,34,95,42,1,Matches
396,397,João Palhinha,pt POR,MF,Sporting CP,26,1995,20.8,81,46,22,52,7,33,57,57.9,24,33,3,30,28,109,25,0,Matches
397,398,Mateus Pasinato,br BRA,GK,Moreirense,29,1992,19.0,1,1,1,0,0,0,1,0.0,1,0,0,0,0,1,10,3,Matches
398,399,Jean Patric,br BRA,"FW,MF",Santa Clara,24,1997,6.3,3,2,1,1,1,2,8,25.0,6,8,0,8,4,7,3,0,Matches
399,400,Patrick,br BRA,DF,Estoril,24,1997,11.5,21,12,14,5,2,14,19,73.7,5,21,18,3,13,34,46,1,Matches
400,401,Patrick,br BRA,MF,Santa Clara,22,1998,0.0,0,0,0,0,0,0,1,0.0,1,0,0,0,0,0,0,0,Matches
401,402,Paulinho,pt POR,"FW,MF",Sporting CP,28,1992,26.4,21,11,1,12,8,5,15,33.3,10,24,2,22,3,24,25,0,Matches
402,403,André Paulo,pt POR,GK,Sporting CP,24,1996,0.1,0,0,0,0,0,0,0,,0,0,0,0,0,0,0,0,Matches
403,404,Marcos Paulo,br BRA,"FW,MF",Famalicão,20,2001,7.6,7,5,2,5,0,0,9,0.0,9,6,0,6,5,12,3,0,Matches
404,405,Marcos Paulo,br BRA,MF,FC Vizela,33,1988,18.8,32,17,12,17,3,15,39,38.5,24,10,6,4,14,46,34,0,Matches
405,406,Pedrão,br BRA,DF,Portimonense,24,1997,27.8,38,19,22,15,1,18,29,62.1,11,36,27,9,53,91,101,0,Matches
406,407,João Pedro,pt POR,MF,Tondela,28,1993,21.3,39,25,20,16,3,21,51,41.2,30,14,4,10,23,62,19,0,Matches
407,408,Pedro Pelágio,pt POR,MF,Marítimo,21,2000,11.1,33,21,16,16,1,12,35,34.3,23,10,3,7,13,46,18,0,Matches
408,409,Pepe,pt POR,DF,Porto,38,1983,19.9,15,14,9,5,1,7,15,46.7,8,11,4,7,26,41,41,0,Matches
409,410,Pepê,br BRA,"MF,DF",Porto,24,1997,15.1,25,11,12,8,5,12,33,36.4,21,10,0,10,14,39,9,0,Matches
410,411,Francisco Pereira,pt POR,MF,Boavista,19,2002,0.0,0,0,0,0,0,0,0,,0,0,0,0,0,0,0,0,Matches
411,412,Marco André Rocha Pereira,pt POR,GK,Santa Clara,34,1987,28.0,0,0,0,0,0,0,0,,0,0,0,0,0,0,5,2,Matches
412,413,Sebastián Pérez Cardona,co COL,MF,Boavista,28,1993,25.1,61,31,36,21,4,27,56,48.2,29,35,7,28,35,96,22,0,Matches
413,414,Luiz Phellype,br BRA,FW,Santa Clara,27,1993,3.1,3,2,0,2,1,0,1,0.0,1,3,1,2,0,3,6,0,Matches
414,415,Thibang Phete,za RSA,"MF,DF",B-SAD,27,1994,20.5,34,14,15,15,4,12,30,40.0,18,21,9,12,23,57,61,0,Matches
415,416,Lucas Piazon,br BRA,"MF,FW",Braga,27,1994,4.0,6,4,0,5,1,2,12,16.7,10,8,2,6,1,7,0,0,Matches
416,417,Charles Pickel,ch SUI,MF,Famalicão,24,1997,26.3,50,29,25,20,5,29,76,38.2,47,39,3,36,37,87,37,0,Matches
417,418,Rodrigo Pinho,br BRA,FW,Benfica,30,1991,0.9,0,0,0,0,0,0,0,,0,0,0,0,0,0,0,0,Matches
418,419,Dinis Pinto,pt POR,MF,Braga,20,2000,0.3,0,0,0,0,0,0,0,,0,0,0,0,0,0,0,0,Matches
419,420,Felipe Pires,br BRA,"FW,MF",Moreirense,26,1995,12.9,10,6,3,6,1,5,20,25.0,15,7,0,7,2,12,3,1,Matches
420,421,Rui Pires,pt POR,MF,Paços,23,1998,13.4,32,18,9,17,6,16,39,41.0,23,19,4,15,14,46,17,0,Matches
421,422,Pité,pt POR,MF,Arouca,26,1994,10.8,31,18,13,15,3,17,33,51.5,16,19,0,19,5,36,5,1,Matches
422,423,Pizzi,pt POR,"MF,FW",Benfica,31,1989,3.6,1,0,0,0,1,1,8,12.5,7,2,0,2,1,2,1,0,Matches
423,424,Jackson Porozo,ec ECU,DF,Boavista,20,2000,23.8,38,28,28,10,0,16,22,72.7,6,26,16,10,37,75,97,0,Matches
424,425,Pedro Porro,es ESP,"DF,MF",Sporting CP,21,1999,18.2,41,25,18,17,6,18,51,35.3,33,22,2,20,25,66,24,0,Matches
425,426,Samuel Portugal,br BRA,GK,Portimonense,27,1994,30.0,0,0,0,0,0,0,2,0.0,2,0,0,0,0,0,16,2,Matches
426,427,Lucas Possignolo,br BRA,DF,Portimonense,27,1994,22.9,28,16,17,9,2,14,29,48.3,15,22,16,6,53,81,89,1,Matches
427,428,Quaresma,br BRA,DF,Arouca,24,1996,27.0,48,33,26,19,3,32,57,56.1,25,24,9,15,42,90,36,1,Matches
428,429,Ricardo Quaresma,pt POR,"FW,MF",Vitória,37,1983,10.9,8,4,1,3,4,4,9,44.4,5,4,0,4,0,8,5,0,Matches
429,430,Diogo Queirós,pt POR,DF,Famalicão,22,1999,0.0,0,0,0,0,0,0,0,,0,0,0,0,0,0,2,0,Matches
430,431,Nemanja Radonjić,rs SRB,"DF,MF",Benfica,25,1996,1.5,3,1,2,1,0,1,2,50.0,1,0,0,0,0,3,2,0,Matches
431,432,Álvaro Ramalho,pt POR,GK,B-SAD,22,1999,2.0,0,0,0,0,0,0,0,,0,0,0,0,0,0,3,0,Matches
432,433,Cláudio Ramos,pt POR,GK,Porto,29,1991,1.0,0,0,0,0,0,0,0,,0,0,0,0,0,0,0,0,Matches
433,434,Flávio Ramos,br BRA,DF,Paços,27,1994,8.7,5,3,3,1,1,3,8,37.5,5,12,10,2,11,16,34,1,Matches
434,435,Gonçalo Ramos,pt POR,"FW,MF",Benfica,20,2001,17.9,16,10,6,9,1,4,16,25.0,12,14,1,13,5,21,13,0,Matches
435,436,Rafael Ramos,pt POR,DF,Santa Clara,26,1995,20.7,44,27,32,10,2,20,33,60.6,13,15,1,14,28,72,54,0,Matches
436,437,Rúben Ramos,pt POR,"MF,DF",Moreirense,22,1999,4.2,3,2,2,1,0,1,5,20.0,4,3,1,2,5,8,4,0,Matches
437,438,Osama Rashid,iq IRQ,MF,FC Vizela,29,1992,6.5,11,6,3,6,2,4,14,28.6,10,2,0,2,7,18,5,0,Matches
438,439,Bruno Reis,pt POR,MF,Portimonense,22,1999,0.7,2,2,1,1,0,1,3,33.3,2,0,0,0,0,2,0,0,Matches
439,440,Matheus Reis,br BRA,DF,Sporting CP,26,1995,23.0,28,19,14,12,2,18,27,66.7,9,26,7,19,23,51,41,0,Matches
440,441,Miguel Reisinho,pt POR,"FW,MF",Boavista,22,1999,0.5,2,2,1,1,0,2,4,50.0,2,0,0,0,1,3,3,0,Matches
441,442,Filipe Relvas,pt POR,DF,Portimonense,21,1999,17.9,18,14,11,7,0,13,18,72.2,5,26,16,10,34,52,65,0,Matches
442,443,Tomás Reymão,pt POR,MF,Boavista,23,1998,3.8,10,5,4,5,1,5,12,41.7,7,2,0,2,8,18,6,0,Matches
443,444,Eduardo Ribeiro,pt POR,MF,Braga,20,2001,0.0,0,0,0,0,0,0,0,,0,0,0,0,0,0,0,0,Matches
444,445,Henrique Ribeiro,pt POR,DF,B-SAD,19,2002,1.0,0,0,0,0,0,0,1,0.0,1,0,0,0,2,2,5,0,Matches
445,446,Tomás Ribeiro,pt POR,DF,B-SAD,22,1999,17.0,19,8,13,5,1,11,19,57.9,8,25,15,10,27,46,88,1,Matches
446,447,Ricardinho,br BRA,FW,Marítimo,20,2001,5.1,7,4,2,4,1,1,8,12.5,7,7,2,5,1,8,6,0,Matches
447,448,Ricardinho,pt POR,"FW,MF",Santa Clara,22,1998,24.0,31,18,15,13,3,22,56,39.3,34,24,3,21,13,44,16,0,Matches
448,449,André Ricardo,pt POR,"FW,MF",Famalicão,20,2000,0.8,1,1,0,1,0,1,2,50.0,1,1,0,1,1,2,0,0,Matches
449,450,Riccieli,br BRA,DF,Famalicão,22,1998,24.2,32,19,23,9,0,21,33,63.6,12,29,22,7,36,68,133,2,Matches
450,451,Rochinha,pt POR,"FW,MF",Vitória,26,1995,21.7,21,16,6,6,9,5,28,17.9,23,8,0,8,11,32,12,1,Matches
451,452,Bruno Rodrigues,pt POR,DF,Braga,20,2001,6.4,6,5,3,3,0,3,4,75.0,1,2,1,1,7,13,25,0,Matches
452,453,Ivo Rodrigues,pt POR,"FW,MF",Famalicão,26,1995,20.7,42,24,12,25,5,21,44,47.7,23,21,3,18,17,59,14,0,Matches
453,454,Pedro Rodrigues,pt POR,MF,Famalicão,24,1997,30.6,57,32,28,24,5,28,71,39.4,43,33,7,26,26,83,23,0,Matches
454,455,Julio Romão,br BRA,"MF,DF",Santa Clara,23,1998,4.0,28,16,11,14,3,10,13,76.9,3,7,3,4,2,30,4,0,Matches
455,456,Lazar Rosić,rs SRB,DF,Moreirense,28,1993,28.0,26,10,18,8,0,15,27,55.6,12,28,24,4,36,62,112,1,Matches
456,457,Loreintz Rosier,fr FRA,MF,Estoril,22,1998,25.5,65,33,37,21,7,32,55,58.2,23,26,8,18,30,95,60,2,Matches
457,458,Iván Rossi,ar ARG,MF,Marítimo,27,1993,19.1,62,30,21,33,8,19,45,42.2,26,29,12,17,32,94,35,0,Matches
458,459,Abel Ruiz,es ESP,"FW,MF",Braga,21,2000,15.4,2,0,0,1,1,2,12,16.7,10,7,2,5,3,5,5,0,Matches
459,460,Alan Ruiz,ar ARG,MF,Arouca,27,1993,5.2,4,3,1,3,0,1,5,20.0,4,3,1,2,1,5,5,0,Matches
460,461,Leonardo Ruíz,co COL,FW,Estoril,25,1996,9.7,7,3,4,3,0,1,9,11.1,8,8,2,6,3,10,8,1,Matches
461,462,Helder Sá,pt POR,DF,Vitória,18,2002,5.6,10,6,5,4,1,5,9,55.6,4,9,3,6,9,19,14,1,Matches
462,463,Pedro Sá,pt POR,MF,Portimonense,27,1993,12.0,28,18,16,12,0,17,37,45.9,20,21,7,14,12,40,37,0,Matches
463,464,Tiago Sá,pt POR,GK,Braga,26,1995,1.0,1,0,1,0,0,1,1,100.0,0,0,0,0,0,1,0,0,Matches
464,465,Falaye Sacko,ml MLI,DF,Vitória,26,1995,10.3,10,7,3,5,2,9,17,52.9,8,8,3,5,13,23,23,0,Matches
465,466,Jorge Sáenz,es ESP,DF,Marítimo,24,1996,4.4,5,4,1,4,0,1,4,25.0,3,6,2,4,10,15,10,0,Matches
466,467,Safira,br BRA,FW,B-SAD,26,1995,16.1,13,6,2,8,3,4,20,20.0,16,17,3,14,4,17,19,0,Matches
467,468,Pierre Sagna,sn SEN,DF,Santa Clara,30,1990,11.5,16,10,10,4,2,9,11,81.8,2,12,3,9,25,41,26,1,Matches
468,469,Modibo Sagnan,fr FRA,DF,Tondela,22,1999,25.0,58,39,44,11,3,34,47,72.3,13,29,18,11,24,82,116,1,Matches
469,470,Braima Sambú,pt POR,MF,B-SAD,20,2001,7.9,16,6,9,4,3,13,24,54.2,11,12,2,10,11,27,13,0,Matches
470,471,Samu,pt POR,MF,FC Vizela,25,1996,27.4,66,36,25,25,16,32,73,43.8,41,48,12,36,38,104,42,0,Matches
471,472,Samuel,br BRA,"FW,MF",Gil Vicente FC,21,1999,32.9,74,44,37,22,15,35,97,36.1,62,56,3,53,26,100,25,0,Matches
472,473,Sandro,br BRA,"MF,FW",B-SAD,32,1989,0.8,6,4,4,2,0,4,6,66.7,2,1,0,1,4,10,4,0,Matches
473,474,Elder Santana,br BRA,"FW,MF",Gil Vicente FC,28,1993,3.7,2,2,0,1,1,0,3,0.0,3,5,2,3,1,3,8,0,Matches
474,475,Adílio Santos,br BRA,FW,Arouca,28,1993,1.7,4,2,2,1,1,1,5,20.0,4,3,0,3,0,4,2,0,Matches
475,476,Jeferson Santos,br BRA,MF,Portimonense,29,1992,0.2,0,0,0,0,0,0,1,0.0,1,0,0,0,1,1,1,0,Matches
476,477,Luís Santos,pt POR,"MF,DF",Boavista,21,2000,6.2,18,12,9,5,4,10,18,55.6,8,3,0,3,2,20,14,1,Matches
477,478,Nuno Santos,pt POR,"DF,MF",Sporting CP,26,1995,23.4,34,22,17,13,4,15,36,41.7,21,9,2,7,28,62,21,1,Matches
478,479,Nuno Santos,pt POR,"MF,FW",Paços,22,1999,25.9,19,9,4,11,4,7,47,14.9,40,19,1,18,25,44,23,0,Matches
479,480,Pablo Santos,br BRA,DF,Moreirense,29,1992,13.6,24,15,18,4,2,14,28,50.0,14,9,4,5,27,51,73,1,Matches
480,481,Rafael Santos,pt POR,MF,B-SAD,24,1997,1.1,1,1,0,1,0,0,1,0.0,1,1,0,1,0,1,0,0,Matches
481,482,Yan Santos,br BRA,"FW,MF",Moreirense,22,1998,19.8,48,30,16,26,6,18,52,34.6,34,24,2,22,13,61,8,0,Matches
482,483,Zaidu Sanusi,ng NGA,DF,Porto,24,1997,19.0,31,17,16,7,8,19,41,46.3,22,17,4,13,29,60,21,0,Matches
483,484,Adewele Sapara,ng NGA,"MF,DF",Portimonense,26,1995,0.6,1,1,0,1,0,0,0,,0,0,0,0,0,1,1,0,Matches
484,485,Pablo Sarabia,es ESP,"MF,FW",Sporting CP,29,1992,23.0,12,2,5,4,3,4,24,16.7,20,23,1,22,4,16,4,0,Matches
485,486,Andrés Sarmiento,co COL,FW,FC Vizela,23,1998,1.6,2,1,2,0,0,1,4,25.0,3,0,0,0,0,2,0,0,Matches
486,487,Gustavo Sauer,br BRA,"FW,MF",Boavista,28,1993,25.5,36,23,17,16,3,18,65,27.7,47,28,4,24,9,45,9,0,Matches
487,488,Guilherme Schettine,br BRA,FW,FC Vizela,25,1995,16.9,10,9,2,4,4,4,10,40.0,6,17,2,15,6,16,7,0,Matches
488,489,Haris Seferović,ch SUI,FW,Benfica,29,1992,4.4,1,0,0,0,1,0,2,0.0,2,2,0,2,0,1,3,1,Matches
489,490,Alfa Semedo,gw GNB,MF,Vitória,23,1997,16.4,42,27,16,20,6,18,42,42.9,24,14,4,10,27,69,28,1,Matches
490,491,Rúben Semedo,pt POR,DF,Porto,27,1994,0.1,0,0,0,0,0,0,0,,0,0,0,0,0,0,0,0,Matches
491,492,Nuno Sequeira,pt POR,DF,Braga,30,1990,4.9,6,4,3,2,1,4,11,36.4,7,4,3,1,8,14,9,0,Matches
492,493,Paulo Sérgio Mota,pt POR,"DF,MF",Moreirense,30,1991,25.7,23,16,14,8,1,12,26,46.2,14,23,6,17,16,39,52,0,Matches
493,494,André Silva,br BRA,FW,Arouca,24,1997,28.1,16,7,1,8,7,6,20,30.0,14,10,0,10,10,26,17,0,Matches
494,495,Bernardo Silva,pt POR,DF,Famalicão,20,2001,0.0,0,0,0,0,0,0,0,,0,0,0,0,0,0,1,0,Matches
495,496,Diogo Silva,br BRA,DF,Gil Vicente FC,26,1995,2.5,1,1,1,0,0,0,2,0.0,2,2,2,0,1,2,8,0,Matches
496,497,João Miguel Macedo Silva,pt POR,GK,Marítimo,26,1995,4.0,0,0,0,0,0,0,0,,0,0,0,0,0,0,6,0,Matches
497,498,João Pedro Sousa Silva,pt POR,"FW,MF",Paços,24,1996,5.6,1,1,0,1,0,0,3,0.0,3,3,2,1,0,1,5,0,Matches
498,499,Jorge Fernando Santos Silva,pt POR,DF,Paços,25,1996,4.5,9,4,7,1,1,6,9,66.7,3,7,3,4,3,12,15,0,Matches
499,500,Leandro Miguel Pereira Silva,pt POR,MF,Arouca,27,1994,24.4,34,21,14,12,8,21,48,43.8,27,29,1,28,27,61,42,1,Matches
500,501,Lucas Silva,br BRA,"FW,MF",Paços,23,1998,21.1,16,8,10,4,2,6,28,21.4,22,21,0,21,15,31,17,0,Matches
501,502,Matheus Silva,br BRA,"DF,MF",Moreirense,23,1997,5.3,6,2,4,1,1,2,4,50.0,2,4,2,2,5,11,22,0,Matches
502,503,Pedro Manuel da Silva Moreira,pt POR,MF,Arouca,32,1989,19.1,27,19,7,18,2,10,28,35.7,18,16,5,11,23,50,21,0,Matches
503,504,Pedro José Moreira Silva,pt POR,GK,FC Vizela,24,1997,18.0,1,1,1,0,0,1,1,100.0,0,1,0,1,0,1,12,3,Matches
504,505,Rafa Silva,pt POR,"MF,FW",Benfica,28,1993,22.6,25,18,8,12,5,9,25,36.0,16,20,1,19,13,38,4,0,Matches
505,506,Raul Silva,br BRA,DF,Estoril,31,1989,5.6,9,6,8,1,0,6,13,46.2,7,11,6,5,5,14,19,0,Matches
506,507,Raul Silva,br BRA,DF,Braga,31,1989,5.7,3,2,1,2,0,3,5,60.0,2,1,0,1,8,11,16,0,Matches
507,508,Tiago Silva,pt POR,MF,Vitória,28,1993,21.9,33,23,9,16,8,16,44,36.4,28,21,0,21,22,55,7,0,Matches
508,509,Sílvio,pt POR,DF,Vitória,33,1987,0.3,0,0,0,0,0,0,0,,0,0,0,0,0,0,0,0,Matches
509,510,David Simão,pt POR,MF,Arouca,31,1990,12.5,24,16,12,11,1,14,28,50.0,14,11,4,7,9,33,5,0,Matches
510,511,Eduardo Simões,pt POR,DF,Tondela,19,2002,17.1,41,28,27,12,2,23,33,69.7,10,16,6,10,20,61,64,0,Matches
511,512,Sphephelo Sithole,za RSA,MF,B-SAD,22,1999,16.6,21,16,6,15,0,11,35,31.4,24,23,8,15,18,39,21,0,Matches
512,513,Islam Slimani,dz ALG,FW,Sporting CP,33,1988,4.8,2,1,0,1,1,0,3,0.0,3,3,1,2,2,4,3,0,Matches
513,514,Eduardo Soares,pt POR,FW,Braga,19,2001,0.1,0,0,0,0,0,0,0,,0,0,0,0,0,0,0,0,Matches
514,515,Everton Soares,br BRA,"MF,FW",Benfica,25,1996,17.8,42,27,16,19,7,15,32,46.9,17,25,2,23,9,51,2,1,Matches
515,516,Filipe Soares,pt POR,MF,Moreirense,22,1999,11.2,16,8,4,8,4,5,27,18.5,22,11,2,9,13,29,6,0,Matches
516,517,Marco Soares,cv CPV,"FW,MF",Arouca,37,1984,0.4,0,0,0,0,0,0,0,,0,0,0,0,0,0,1,0,Matches
517,518,Rafa Soares,pt POR,DF,Vitória,26,1995,28.2,40,24,27,11,2,26,41,63.4,15,22,6,16,33,73,52,1,Matches
518,519,Tim Söderström,se SWE,DF,Marítimo,27,1994,0.8,2,1,0,1,1,1,1,100.0,0,0,0,0,2,4,2,0,Matches
519,520,Carles Soria,es ESP,DF,Estoril,24,1996,20.2,25,14,11,10,4,19,31,61.3,12,19,6,13,23,48,40,0,Matches
520,521,Afonso Sousa,pt POR,"MF,FW",B-SAD,21,2000,25.1,38,24,18,13,7,22,56,39.3,34,13,1,12,24,62,8,0,Matches
521,522,César Sousa,ao ANG,MF,B-SAD,21,2000,5.4,24,15,14,8,2,13,34,38.2,21,10,1,9,11,35,5,0,Matches
522,523,Miguel Sousa,pt POR,MF,Marítimo,22,1998,3.1,3,2,0,2,1,0,1,0.0,1,4,0,4,0,3,2,0,Matches
523,524,Claudemir de Souza,br BRA,MF,FC Vizela,33,1988,22.3,27,15,10,13,4,14,39,35.9,25,21,8,13,27,54,52,1,Matches
524,525,Adel Taarabt,ma MAR,MF,Benfica,32,1989,9.6,16,10,9,5,2,13,25,52.0,12,12,3,9,7,23,4,0,Matches
525,526,Bruno Tabata,,"FW,MF",Sporting CP,24,1997,4.5,16,11,8,6,2,6,11,54.5,5,4,0,4,3,19,2,0,Matches
526,527,Kyosuke Tagawa,jp JPN,"FW,MF",Santa Clara,22,1999,5.4,1,0,0,1,0,0,1,0.0,1,0,0,0,0,1,0,0,Matches
527,528,Afonso Taira,pt POR,MF,B-SAD,29,1992,0.2,0,0,0,0,0,0,0,,0,0,0,0,1,1,0,0,Matches
528,529,Talocha,pt POR,DF,Gil Vicente FC,31,1989,30.9,28,18,11,15,2,11,20,55.0,9,17,10,7,29,57,95,0,Matches
529,530,Douglas Tanque,br BRA,FW,Paços,27,1993,1.6,1,0,0,0,1,0,1,0.0,1,3,0,3,0,1,2,0,Matches
530,531,Mehdi Taremi,ir IRN,FW,Porto,29,1992,26.9,11,2,3,4,4,5,27,18.5,22,29,0,29,14,25,17,1,Matches
531,532,David Tavares,pt POR,MF,Famalicão,22,1999,5.0,13,5,7,5,1,7,15,46.7,8,3,2,1,3,16,4,0,Matches
532,533,Gilson Tavares,cv CPV,FW,Estoril,19,2001,0.1,0,0,0,0,0,0,0,,0,0,0,0,1,1,0,0,Matches
533,534,Heriberto Tavares,pt POR,"FW,MF",Famalicão,24,1997,8.4,15,11,6,5,4,7,22,31.8,15,13,2,11,6,21,11,0,Matches
534,535,Yohan Tavares,pt POR,DF,B-SAD,33,1988,28.0,44,26,36,6,2,23,37,62.2,14,38,23,15,31,75,97,1,Matches
535,536,André Teles,pt POR,MF,Marítimo,24,1997,1.2,1,1,0,0,1,0,0,,0,0,0,0,0,1,1,0,Matches
536,537,Guo Tianyu,cn CHN,FW,FC Vizela,22,1999,0.4,0,0,0,0,0,0,0,,0,0,0,0,1,1,0,0,Matches
537,538,Tiago Tomás,pt POR,"MF,FW",Sporting CP,19,2002,1.9,3,2,0,3,0,1,5,20.0,4,7,0,7,2,5,0,0,Matches
538,539,Vítor Tormena,br BRA,DF,Braga,25,1996,20.7,13,9,6,7,0,9,20,45.0,11,16,9,7,28,41,65,2,Matches
539,540,Pedro Trigueira,pt POR,GK,Tondela,33,1988,28.9,1,0,1,0,0,1,3,33.3,2,2,0,2,1,2,17,2,Matches
540,541,Matouš Trmal,cz CZE,GK,Vitória,22,1998,9.0,0,0,0,0,0,0,0,,0,0,0,0,1,1,5,1,Matches
541,542,Manuel Ugarte Ribeiro,uy URU,MF,Sporting CP,20,2001,12.3,45,24,10,28,7,24,56,42.9,32,27,0,27,29,74,8,0,Matches
542,543,Zé Uilton,br BRA,"FW,DF",Paços,29,1992,21.0,23,12,10,9,4,11,27,40.7,16,10,1,9,22,45,26,0,Matches
543,544,Iker Undabarrena,es ESP,MF,Tondela,26,1995,22.3,40,28,22,14,4,26,54,48.1,28,26,6,20,35,75,27,1,Matches
544,545,Mateus Uribe,co COL,MF,Porto,30,1991,22.1,64,41,25,36,3,26,61,42.6,35,16,4,12,35,99,28,0,Matches
545,546,Eugeni Valderrama,es ESP,MF,Arouca,27,1994,5.9,12,5,3,9,0,6,13,46.2,7,5,1,4,6,18,0,0,Matches
546,547,Rodrigo Valente,pt POR,"MF,FW",Estoril,20,2001,0.5,1,1,0,1,0,0,0,,0,0,0,0,1,2,1,0,Matches
547,548,Bruno Varela,pt POR,GK,Vitória,26,1994,25.0,1,0,1,0,0,1,2,50.0,1,0,0,0,1,2,16,0,Matches
548,549,Nilton Varela,pt POR,"DF,MF",B-SAD,20,2001,8.7,18,12,12,6,0,8,18,44.4,10,19,2,17,15,33,9,0,Matches
549,550,Luciano Vega,ar ARG,MF,Estoril,21,1999,1.2,3,3,1,2,0,1,3,33.3,2,1,0,1,1,4,2,0,Matches
550,551,Igor Vekič,si SVN,GK,Paços,23,1998,0.0,0,0,0,0,0,0,0,,0,0,0,0,0,0,0,0,Matches
551,552,Calvin Verdonk,nl NED,FW,Famalicão,24,1997,0.2,0,0,0,0,0,0,0,,0,0,0,0,0,0,0,0,Matches
552,553,Lucas Veríssimo,br BRA,DF,Benfica,26,1995,9.3,16,9,6,8,2,12,20,60.0,8,7,5,2,17,33,29,0,Matches
553,554,Jan Vertonghen,be BEL,DF,Benfica,34,1987,27.6,33,21,14,14,5,16,30,53.3,14,21,16,5,33,66,76,0,Matches
554,555,Paulo Victor Vidotti,br BRA,GK,Marítimo,34,1987,30.0,0,0,0,0,0,0,1,0.0,1,0,0,0,1,1,17,2,Matches
555,556,André Vidigal,pt POR,"FW,MF",Marítimo,22,1998,23.9,28,16,10,14,4,8,20,40.0,12,17,0,17,9,37,15,1,Matches
556,557,Fabio Vieira,pt POR,"MF,FW",Porto,21,2000,14.8,19,14,1,13,5,10,20,50.0,10,10,0,10,10,29,7,0,Matches
557,558,Mikel Villanueva,ve VEN,DF,Santa Clara,28,1993,19.8,22,17,16,6,0,16,26,61.5,10,18,14,4,35,57,80,2,Matches
558,559,Rúben Vinagre,pt POR,"DF,MF",Sporting CP,22,1999,6.0,13,9,5,5,3,4,10,40.0,6,4,0,4,6,19,7,0,Matches
559,560,Carlos Vinícius,br BRA,FW,Benfica,26,1995,0.1,0,0,0,0,0,0,0,,0,0,0,0,0,0,0,0,Matches
560,561,João Virgínia,pt POR,GK,Sporting CP,21,1999,0.9,0,0,0,0,0,0,0,,0,0,0,0,0,0,0,0,Matches
561,562,Bernardo Vital,pt POR,DF,Estoril,20,2000,15.4,6,4,3,3,0,4,9,44.4,5,26,23,3,10,16,58,0,Matches
562,563,Vitinha,pt POR,MF,Porto,21,2000,25.0,49,30,11,28,10,23,41,56.1,18,25,4,21,36,85,14,1,Matches
563,564,Vitinha,pt POR,FW,Braga,21,2000,16.4,19,12,1,9,9,4,16,25.0,12,13,4,9,7,26,19,0,Matches
564,565,Steven Vitória,ca CAN,DF,Moreirense,34,1987,15.8,12,7,7,4,1,5,10,50.0,5,16,9,7,11,23,74,0,Matches
565,566,Odisseas Vlachodimos,gr GRE,GK,Benfica,27,1994,32.0,1,1,1,0,0,1,3,33.3,2,0,0,0,0,1,10,1,Matches
566,567,Ilija Vukotić,me MNE,MF,Boavista,22,1999,9.0,14,5,6,8,0,5,15,33.3,10,10,7,3,6,20,11,0,Matches
567,568,Luca Waldschmidt,de GER,"FW,MF",Benfica,25,1996,1.6,3,2,0,3,0,0,0,,0,2,0,2,0,3,1,0,Matches
568,569,Walterson,br BRA,"FW,MF",Moreirense,26,1994,15.8,36,23,12,16,8,12,41,29.3,29,15,1,14,16,52,9,0,Matches
569,570,Julian Weigl,de GER,MF,Benfica,25,1995,26.8,57,36,16,36,5,31,48,64.6,17,34,7,27,40,97,47,1,Matches
570,571,Wendell,br BRA,DF,Porto,28,1993,10.6,31,18,11,13,7,17,27,63.0,10,14,2,12,13,44,19,0,Matches
571,572,Willyan,br BRA,"DF,MF",Portimonense,26,1995,23.7,53,30,33,17,3,25,40,62.5,15,27,15,12,47,100,105,0,Matches
572,573,Bruno Wilson,pt POR,DF,FC Vizela,24,1996,15.8,16,11,10,6,0,8,13,61.5,5,19,14,5,23,39,56,0,Matches
573,574,Cláudio Winck,br BRA,DF,Marítimo,27,1994,28.6,59,40,28,26,5,38,73,52.1,35,36,10,26,27,86,63,0,Matches
574,575,Xadas,pt POR,"MF,FW",Marítimo,23,1997,14.6,21,14,7,13,1,12,25,48.0,13,15,2,13,4,25,2,0,Matches
575,576,António Xavier,pt POR,"FW,MF",Estoril,29,1992,7.2,6,6,1,4,1,3,13,23.1,10,6,0,6,7,13,3,0,Matches
576,577,Roman Yaremchuk,ua UKR,FW,Benfica,25,1995,11.9,5,3,0,4,1,2,5,40.0,3,3,0,3,0,5,5,0,Matches
577,578,Hugues Zagbayou,ci CIV,MF,FC Vizela,31,1990,4.3,9,5,1,8,0,3,6,50.0,3,5,1,4,6,15,2,0,Matches
578,579,Ivan Zlobin,ru RUS,GK,Famalicão,24,1997,1.0,0,0,0,0,0,0,0,,0,0,0,0,0,0,1,0,Matches
579,580,Kévin Zohi,ml MLI,FW,FC Vizela,24,1996,9.2,10,6,5,5,0,2,9,22.2,7,10,0,10,5,15,11,0,Matches
580,581,Emilijus Zubas,lt LTU,GK,Arouca,31,1990,1.0,0,0,0,0,0,0,0,,0,0,0,0,0,0,0,0,Matches
